area_code,area,GG,gg,yyyy,population,man,woman
陷茨ｽｨ陜暦ｽｽ,陞滂ｽｧ雎�ｽ｣,9,1920,,55963053,28044185,27918868
陋ｹ邇ｲ�ｵ�ｷ鬩包ｿｽ,陞滂ｽｧ雎�ｽ｣,9,1920,,2359183,1244322,1114861
鬮ｱ蜻茨ｽ｣�ｮ騾ｵ�ｽ,陞滂ｽｧ雎�ｽ｣,9,1920,,756454,381293,375161
陝ｯ�ｩ隰�距諱�,陞滂ｽｧ雎�ｽ｣,9,1920,,845540,421069,424471
陞ｳ�ｮ陜灘ｮ域＝,陞滂ｽｧ雎�ｽ｣,9,1920,,961768,485309,476459
驕倡距莨宣ｵ�ｽ,陞滂ｽｧ雎�ｽ｣,9,1920,,898537,453682,444855
陞ｻ�ｱ陟厄ｽ｢騾ｵ�ｽ,陞滂ｽｧ雎�ｽ｣,9,1920,,968925,478328,490597
驕紋ｸ橸ｽｳ�ｶ騾ｵ�ｽ,陞滂ｽｧ雎�ｽ｣,9,1920,,1362750,673525,689225
髣鯉ｽｨ陜灘ｮ域＝,陞滂ｽｧ雎�ｽ｣,9,1920,,1350400,662128,688272
隴ｬ�ｽ諠�騾ｵ�ｽ,陞滂ｽｧ雎�ｽ｣,9,1920,,1046479,514255,532224
驗抵ｽ､鬯･�ｬ騾ｵ�ｽ,陞滂ｽｧ雎�ｽ｣,9,1920,,1052610,514106,538504
陜難ｽｼ驍��諱�,陞滂ｽｧ雎�ｽ｣,9,1920,,1319533,641161,678372
陷奇ｿｽ逞ｩ騾ｵ�ｽ,陞滂ｽｧ雎�ｽ｣,9,1920,,1336155,656968,679187
隴夲ｽｱ闔��ｬ鬩幢ｽｽ,陞滂ｽｧ雎�ｽ｣,9,1920,,3699428,1952989,1746439
騾ｾ讒ｫ�･莠･�ｷ譎画＝,陞滂ｽｧ雎�ｽ｣,9,1920,,1323390,689751,633639
隴�ｽｰ雋取ｺｽ諱�,陞滂ｽｧ雎�ｽ｣,9,1920,,1776474,871532,904942
陝�ぁ�ｱ�ｱ騾ｵ�ｽ,陞滂ｽｧ雎�ｽ｣,9,1920,,724276,354775,369501
驕擾ｽｳ陝ｾ譎画＝,陞滂ｽｧ雎�ｽ｣,9,1920,,747360,364375,382985
驕紋ｸ茨ｽｺ諷墓＝,陞滂ｽｧ雎�ｽ｣,9,1920,,599155,293181,305974
陞ｻ�ｱ隴ｴ�ｨ騾ｵ�ｽ,陞滂ｽｧ雎�ｽ｣,9,1920,,583453,290817,292636
鬮滂ｽｷ鬩･螳域＝,陞滂ｽｧ雎�ｽ｣,9,1920,,1562722,758639,804083
陝ｯ螳｣�ｽ騾ｵ�ｽ,陞滂ｽｧ雎�ｽ｣,9,1920,,1070407,536334,534073
鬮ｱ蜷晢ｽｲ�｡騾ｵ�ｽ,陞滂ｽｧ雎�ｽ｣,9,1920,,1550387,774169,776218
隲｢蟶ｷ陦埼ｵ�ｽ,陞滂ｽｧ雎�ｽ｣,9,1920,,2089762,1033860,1055902
闕ｳ陋ｾ纃ｾ騾ｵ�ｽ,陞滂ｽｧ雎�ｽ｣,9,1920,,1069270,525957,543313
雋顔事�ｳﾂ騾ｵ�ｽ,陞滂ｽｧ雎�ｽ｣,9,1920,,651050,313737,337313
闔��ｬ鬩幢ｽｽ陟趣ｿｽ,陞滂ｽｧ雎�ｽ｣,9,1920,,1287147,650780,636367
陞滂ｽｧ鬮ｦ�ｪ陟趣ｿｽ,陞滂ｽｧ雎�ｽ｣,9,1920,,2587847,1344846,1243001
陷茨ｽｵ陟趣ｽｫ騾ｵ�ｽ,陞滂ｽｧ雎�ｽ｣,9,1920,,2301799,1175426,1126373
陞るメ諞ｶ騾ｵ�ｽ,陞滂ｽｧ雎�ｽ｣,9,1920,,564607,280383,284224
陷･譴ｧ�ｭ謔滂ｽｱ�ｱ騾ｵ�ｽ,陞滂ｽｧ雎�ｽ｣,9,1920,,750411,372058,378353
鬲托ｽ･陷ｿ荵滓＝,陞滂ｽｧ雎�ｽ｣,9,1920,,454675,222802,231873
陝ｲ�ｶ隴ｬ�ｹ騾ｵ�ｽ,陞滂ｽｧ雎�ｽ｣,9,1920,,714712,354959,359753
陝ｯ�｡陞ｻ�ｱ騾ｵ�ｽ,陞滂ｽｧ雎�ｽ｣,9,1920,,1217698,605316,612382
陟趣ｿｽ�ｳ�ｶ騾ｵ�ｽ,陞滂ｽｧ雎�ｽ｣,9,1920,,1541905,775080,766825
陞ｻ�ｱ陷ｿ�｣騾ｵ�ｽ,陞滂ｽｧ雎�ｽ｣,9,1920,,1041013,521041,519972
陟包ｽｳ陝ｲ�ｶ騾ｵ�ｽ,陞滂ｽｧ雎�ｽ｣,9,1920,,670212,331768,338444
鬯･蜷晢ｽｷ譎画＝,陞滂ｽｧ雎�ｽ｣,9,1920,,677852,336195,341657
隲｢蟶幢ｽｪ蟶ｷ諱�,陞滂ｽｧ雎�ｽ｣,9,1920,,1046720,515389,531331
鬯ｮ蛟｡陦埼ｵ�ｽ,陞滂ｽｧ雎�ｽ｣,9,1920,,670895,332087,338808
驕紋ｸ橸ｽｲ�｡騾ｵ�ｽ,陞滂ｽｧ雎�ｽ｣,9,1920,,2188249,1116818,1071431
闖ｴ蜊��ｳﾂ騾ｵ�ｽ,陞滂ｽｧ雎�ｽ｣,9,1920,,673895,329962,343933
鬮滂ｽｷ陝�螳域＝,陞滂ｽｧ雎�ｽ｣,9,1920,,1136182,584234,551948
霎ｭ鬆第た騾ｵ�ｽ,陞滂ｽｧ雎�ｽ｣,9,1920,,1233233,602389,630844
陞滂ｽｧ陋ｻ�ｽ諱�,陞滂ｽｧ雎�ｽ｣,9,1920,,860282,422708,437574
陞ｳ�ｮ陝�螳域＝,陞滂ｽｧ雎�ｽ｣,9,1920,,651097,326610,324487
魄厄ｽｿ陷井ｻ呻ｽｳ�ｶ騾ｵ�ｽ,陞滂ｽｧ雎�ｽ｣,9,1920,,1415582,682243,733339
雎蝉ｹ滂ｽｸ�ｽ諱�,陞滂ｽｧ雎�ｽ｣,9,1920,,571572,274829,296743
陷茨ｽｨ陜暦ｽｽ,陞滂ｽｧ雎�ｽ｣,14,1925,,59736822,30013109,29723713
陋ｹ邇ｲ�ｵ�ｷ鬩包ｿｽ,陞滂ｽｧ雎�ｽ｣,14,1925,,2498679,1305473,1193206
鬮ｱ蜻茨ｽ｣�ｮ騾ｵ�ｽ,陞滂ｽｧ雎�ｽ｣,14,1925,,812977,408770,404207
陝ｯ�ｩ隰�距諱�,陞滂ｽｧ雎�ｽ｣,14,1925,,900984,448637,452347
陞ｳ�ｮ陜灘ｮ域＝,陞滂ｽｧ雎�ｽ｣,14,1925,,1044036,525191,518845
驕倡距莨宣ｵ�ｽ,陞滂ｽｧ雎�ｽ｣,14,1925,,936408,470737,465671
陞ｻ�ｱ陟厄ｽ｢騾ｵ�ｽ,陞滂ｽｧ雎�ｽ｣,14,1925,,1027297,506303,520994
驕紋ｸ橸ｽｳ�ｶ騾ｵ�ｽ,陞滂ｽｧ雎�ｽ｣,14,1925,,1437596,710606,726990
髣鯉ｽｨ陜灘ｮ域＝,陞滂ｽｧ雎�ｽ｣,14,1925,,1409092,693837,715255
隴ｬ�ｽ諠�騾ｵ�ｽ,陞滂ｽｧ雎�ｽ｣,14,1925,,1090428,536259,554169
驗抵ｽ､鬯･�ｬ騾ｵ�ｽ,陞滂ｽｧ雎�ｽ｣,14,1925,,1118858,548633,570225
陜難ｽｼ驍��諱�,陞滂ｽｧ雎�ｽ｣,14,1925,,1394461,682052,712409
陷奇ｿｽ逞ｩ騾ｵ�ｽ,陞滂ｽｧ雎�ｽ｣,14,1925,,1399257,691242,708015
隴夲ｽｱ闔��ｬ鬩幢ｽｽ,陞滂ｽｧ雎�ｽ｣,14,1925,,4485144,2387609,2097535
騾ｾ讒ｫ�･莠･�ｷ譎画＝,陞滂ｽｧ雎�ｽ｣,14,1925,,1416792,739699,677093
隴�ｽｰ雋取ｺｽ諱�,陞滂ｽｧ雎�ｽ｣,14,1925,,1849807,913886,935921
陝�ぁ�ｱ�ｱ騾ｵ�ｽ,陞滂ｽｧ雎�ｽ｣,14,1925,,749243,368593,380650
驕擾ｽｳ陝ｾ譎画＝,陞滂ｽｧ雎�ｽ｣,14,1925,,750854,365597,385257
驕紋ｸ茨ｽｺ諷墓＝,陞滂ｽｧ雎�ｽ｣,14,1925,,597899,293039,304860
陞ｻ�ｱ隴ｴ�ｨ騾ｵ�ｽ,陞滂ｽｧ雎�ｽ｣,14,1925,,600675,300289,300386
鬮滂ｽｷ鬩･螳域＝,陞滂ｽｧ雎�ｽ｣,14,1925,,1629217,793875,835342
陝ｯ螳｣�ｽ騾ｵ�ｽ,陞滂ｽｧ雎�ｽ｣,14,1925,,1132557,567837,564720
鬮ｱ蜷晢ｽｲ�｡騾ｵ�ｽ,陞滂ｽｧ雎�ｽ｣,14,1925,,1671217,835521,835696
隲｢蟶ｷ陦埼ｵ�ｽ,陞滂ｽｧ雎�ｽ｣,14,1925,,2319494,1150325,1169169
闕ｳ陋ｾ纃ｾ騾ｵ�ｽ,陞滂ｽｧ雎�ｽ｣,14,1925,,1107692,544752,562940
雋顔事�ｳﾂ騾ｵ�ｽ,陞滂ｽｧ雎�ｽ｣,14,1925,,662412,321071,341341
闔��ｬ鬩幢ｽｽ陟趣ｿｽ,陞滂ｽｧ雎�ｽ｣,14,1925,,1406382,717464,688918
陞滂ｽｧ鬮ｦ�ｪ陟趣ｿｽ,陞滂ｽｧ雎�ｽ｣,14,1925,,3059502,1594227,1465275
陷茨ｽｵ陟趣ｽｫ騾ｵ�ｽ,陞滂ｽｧ雎�ｽ｣,14,1925,,2454679,1239326,1215353
陞るメ諞ｶ騾ｵ�ｽ,陞滂ｽｧ雎�ｽ｣,14,1925,,583828,289770,294058
陷･譴ｧ�ｭ謔滂ｽｱ�ｱ騾ｵ�ｽ,陞滂ｽｧ雎�ｽ｣,14,1925,,787511,392191,395320
鬲托ｽ･陷ｿ荵滓＝,陞滂ｽｧ雎�ｽ｣,14,1925,,472230,230580,241650
陝ｲ�ｶ隴ｬ�ｹ騾ｵ�ｽ,陞滂ｽｧ雎�ｽ｣,14,1925,,722402,359987,362415
陝ｯ�｡陞ｻ�ｱ騾ｵ�ｽ,陞滂ｽｧ雎�ｽ｣,14,1925,,1238447,613619,624828
陟趣ｿｽ�ｳ�ｶ騾ｵ�ｽ,陞滂ｽｧ雎�ｽ｣,14,1925,,1617680,818266,799414
陞ｻ�ｱ陷ｿ�｣騾ｵ�ｽ,陞滂ｽｧ雎�ｽ｣,14,1925,,1094544,552793,541751
陟包ｽｳ陝ｲ�ｶ騾ｵ�ｽ,陞滂ｽｧ雎�ｽ｣,14,1925,,689814,344550,345264
鬯･蜷晢ｽｷ譎画＝,陞滂ｽｧ雎�ｽ｣,14,1925,,700308,351911,348397
隲｢蟶幢ｽｪ蟶ｷ諱�,陞滂ｽｧ雎�ｽ｣,14,1925,,1096366,542271,554095
鬯ｮ蛟｡陦埼ｵ�ｽ,陞滂ｽｧ雎�ｽ｣,14,1925,,687478,341687,345791
驕紋ｸ橸ｽｲ�｡騾ｵ�ｽ,陞滂ｽｧ雎�ｽ｣,14,1925,,2301668,1166165,1135503
闖ｴ蜊��ｳﾂ騾ｵ�ｽ,陞滂ｽｧ雎�ｽ｣,14,1925,,684831,336223,348608
鬮滂ｽｷ陝�螳域＝,陞滂ｽｧ雎�ｽ｣,14,1925,,1163945,593472,570473
霎ｭ鬆第た騾ｵ�ｽ,陞滂ｽｧ雎�ｽ｣,14,1925,,1296086,637753,658333
陞滂ｽｧ陋ｻ�ｽ諱�,陞滂ｽｧ雎�ｽ｣,14,1925,,915136,451298,463838
陞ｳ�ｮ陝�螳域＝,陞滂ｽｧ雎�ｽ｣,14,1925,,691094,348088,343006
魄厄ｽｿ陷井ｻ呻ｽｳ�ｶ騾ｵ�ｽ,陞滂ｽｧ雎�ｽ｣,14,1925,,1472193,713702,758491
雎蝉ｹ滂ｽｸ�ｽ諱�,陞滂ｽｧ雎�ｽ｣,14,1925,,557622,267933,289689
陷茨ｽｨ陜暦ｽｽ,隴擾ｽｭ陷･�ｽ,5,1930,,64450005,32390155,32059850
陋ｹ邇ｲ�ｵ�ｷ鬩包ｿｽ,隴擾ｽｭ陷･�ｽ,5,1930,,2812335,1468540,1343795
鬮ｱ蜻茨ｽ｣�ｮ騾ｵ�ｽ,隴擾ｽｭ陷･�ｽ,5,1930,,879914,441441,438473
陝ｯ�ｩ隰�距諱�,隴擾ｽｭ陷･�ｽ,5,1930,,975771,486925,488846
陞ｳ�ｮ陜灘ｮ域＝,隴擾ｽｭ陷･�ｽ,5,1930,,1142784,575335,567449
驕倡距莨宣ｵ�ｽ,隴擾ｽｭ陷･�ｽ,5,1930,,987706,495009,492697
陞ｻ�ｱ陟厄ｽ｢騾ｵ�ｽ,隴擾ｽｭ陷･�ｽ,5,1930,,1080034,532377,547657
驕紋ｸ橸ｽｳ�ｶ騾ｵ�ｽ,隴擾ｽｭ陷･�ｽ,5,1930,,1508150,742342,765808
髣鯉ｽｨ陜灘ｮ域＝,隴擾ｽｭ陷･�ｽ,5,1930,,1487097,734059,753038
隴ｬ�ｽ諠�騾ｵ�ｽ,隴擾ｽｭ陷･�ｽ,5,1930,,1141737,562839,578898
驗抵ｽ､鬯･�ｬ騾ｵ�ｽ,隴擾ｽｭ陷･�ｽ,5,1930,,1186080,581007,605073
陜難ｽｼ驍��諱�,隴擾ｽｭ陷･�ｽ,5,1930,,1459172,718779,740393
陷奇ｿｽ逞ｩ騾ｵ�ｽ,隴擾ｽｭ陷･�ｽ,5,1930,,1470121,729439,740682
隴夲ｽｱ闔��ｬ鬩幢ｽｽ,隴擾ｽｭ陷･�ｽ,5,1930,,5408678,2855323,2553355
騾ｾ讒ｫ�･莠･�ｷ譎画＝,隴擾ｽｭ陷･�ｽ,5,1930,,1619606,839309,780297
隴�ｽｰ雋取ｺｽ諱�,隴擾ｽｭ陷･�ｽ,5,1930,,1933326,955621,977705
陝�ぁ�ｱ�ｱ騾ｵ�ｽ,隴擾ｽｭ陷･�ｽ,5,1930,,778953,381809,397144
驕擾ｽｳ陝ｾ譎画＝,隴擾ｽｭ陷･�ｽ,5,1930,,756835,368402,388433
驕紋ｸ茨ｽｺ諷墓＝,隴擾ｽｭ陷･�ｽ,5,1930,,618144,304525,313619
陞ｻ�ｱ隴ｴ�ｨ騾ｵ�ｽ,隴擾ｽｭ陷･�ｽ,5,1930,,631042,315327,315715
鬮滂ｽｷ鬩･螳域＝,隴擾ｽｭ陷･�ｽ,5,1930,,1717118,832312,884806
陝ｯ螳｣�ｽ騾ｵ�ｽ,隴擾ｽｭ陷･�ｽ,5,1930,,1178405,591049,587356
鬮ｱ蜷晢ｽｲ�｡騾ｵ�ｽ,隴擾ｽｭ陷･�ｽ,5,1930,,1797805,900640,897165
隲｢蟶ｷ陦埼ｵ�ｽ,隴擾ｽｭ陷･�ｽ,5,1930,,2567413,1277720,1289693
闕ｳ陋ｾ纃ｾ騾ｵ�ｽ,隴擾ｽｭ陷･�ｽ,5,1930,,1157407,571000,586407
雋顔事�ｳﾂ騾ｵ�ｽ,隴擾ｽｭ陷･�ｽ,5,1930,,691631,337016,354615
闔��ｬ鬩幢ｽｽ陟趣ｿｽ,隴擾ｽｭ陷･�ｽ,5,1930,,1552832,792420,760412
陞滂ｽｧ鬮ｦ�ｪ陟趣ｿｽ,隴擾ｽｭ陷･�ｽ,5,1930,,3540017,1845786,1694231
陷茨ｽｵ陟趣ｽｫ騾ｵ�ｽ,隴擾ｽｭ陷･�ｽ,5,1930,,2646301,1332918,1313383
陞るメ諞ｶ騾ｵ�ｽ,隴擾ｽｭ陷･�ｽ,5,1930,,596225,295456,300769
陷･譴ｧ�ｭ謔滂ｽｱ�ｱ騾ｵ�ｽ,隴擾ｽｭ陷･�ｽ,5,1930,,830748,415035,415713
鬲托ｽ･陷ｿ荵滓＝,隴擾ｽｭ陷･�ｽ,5,1930,,489266,239084,250182
陝ｲ�ｶ隴ｬ�ｹ騾ｵ�ｽ,隴擾ｽｭ陷･�ｽ,5,1930,,739507,368888,370619
陝ｯ�｡陞ｻ�ｱ騾ｵ�ｽ,隴擾ｽｭ陷･�ｽ,5,1930,,1283962,637965,645997
陟趣ｿｽ�ｳ�ｶ騾ｵ�ｽ,隴擾ｽｭ陷･�ｽ,5,1930,,1692136,856737,835399
陞ｻ�ｱ陷ｿ�｣騾ｵ�ｽ,隴擾ｽｭ陷･�ｽ,5,1930,,1135637,571642,563995
陟包ｽｳ陝ｲ�ｶ騾ｵ�ｽ,隴擾ｽｭ陷･�ｽ,5,1930,,716544,356958,359586
鬯･蜷晢ｽｷ譎画＝,隴擾ｽｭ陷･�ｽ,5,1930,,732816,368442,364374
隲｢蟶幢ｽｪ蟶ｷ諱�,隴擾ｽｭ陷･�ｽ,5,1930,,1142122,564699,577423
鬯ｮ蛟｡陦埼ｵ�ｽ,隴擾ｽｭ陷･�ｽ,5,1930,,718152,357166,360986
驕紋ｸ橸ｽｲ�｡騾ｵ�ｽ,隴擾ｽｭ陷･�ｽ,5,1930,,2527119,1280624,1246495
闖ｴ蜊��ｳﾂ騾ｵ�ｽ,隴擾ｽｭ陷･�ｽ,5,1930,,691565,337996,353569
鬮滂ｽｷ陝�螳域＝,隴擾ｽｭ陷･�ｽ,5,1930,,1233362,630525,602837
霎ｭ鬆第た騾ｵ�ｽ,隴擾ｽｭ陷･�ｽ,5,1930,,1353993,664106,689887
陞滂ｽｧ陋ｻ�ｽ諱�,隴擾ｽｭ陷･�ｽ,5,1930,,945771,465994,479777
陞ｳ�ｮ陝�螳域＝,隴擾ｽｭ陷･�ｽ,5,1930,,760467,383128,377339
魄厄ｽｿ陷井ｻ呻ｽｳ�ｶ騾ｵ�ｽ,隴擾ｽｭ陷･�ｽ,5,1930,,1556690,753644,803046
雎蝉ｹ滂ｽｸ�ｽ諱�,隴擾ｽｭ陷･�ｽ,5,1930,,577509,272797,304712
陷茨ｽｨ陜暦ｽｽ,隴擾ｽｭ陷･�ｽ,10,1935,,69254148,34734133,34520015
陋ｹ邇ｲ�ｵ�ｷ鬩包ｿｽ,隴擾ｽｭ陷･�ｽ,10,1935,,3068282,1593845,1474437
鬮ｱ蜻茨ｽ｣�ｮ騾ｵ�ｽ,隴擾ｽｭ陷･�ｽ,10,1935,,967129,484277,482852
陝ｯ�ｩ隰�距諱�,隴擾ｽｭ陷･�ｽ,10,1935,,1046111,519485,526626
陞ｳ�ｮ陜灘ｮ域＝,隴擾ｽｭ陷･�ｽ,10,1935,,1234801,622973,611828
驕倡距莨宣ｵ�ｽ,隴擾ｽｭ陷･�ｽ,10,1935,,1037744,519249,518495
陞ｻ�ｱ陟厄ｽ｢騾ｵ�ｽ,隴擾ｽｭ陷･�ｽ,10,1935,,1116822,549060,567762
驕紋ｸ橸ｽｳ�ｶ騾ｵ�ｽ,隴擾ｽｭ陷･�ｽ,10,1935,,1581563,778732,802831
髣鯉ｽｨ陜灘ｮ域＝,隴擾ｽｭ陷･�ｽ,10,1935,,1548991,766423,782568
隴ｬ�ｽ諠�騾ｵ�ｽ,隴擾ｽｭ陷･�ｽ,10,1935,,1195057,588545,606512
驗抵ｽ､鬯･�ｬ騾ｵ�ｽ,隴擾ｽｭ陷･�ｽ,10,1935,,1242453,606779,635674
陜難ｽｼ驍��諱�,隴擾ｽｭ陷･�ｽ,10,1935,,1528854,753802,775052
陷奇ｿｽ逞ｩ騾ｵ�ｽ,隴擾ｽｭ陷･�ｽ,10,1935,,1546394,764751,781643
隴夲ｽｱ闔��ｬ鬩幢ｽｽ,隴擾ｽｭ陷･�ｽ,10,1935,,6369919,3325696,3044223
騾ｾ讒ｫ�･莠･�ｷ譎画＝,隴擾ｽｭ陷･�ｽ,10,1935,,1840005,951348,888657
隴�ｽｰ雋取ｺｽ諱�,隴擾ｽｭ陷･�ｽ,10,1935,,1995777,982497,1013280
陝�ぁ�ｱ�ｱ騾ｵ�ｽ,隴擾ｽｭ陷･�ｽ,10,1935,,798890,388771,410119
驕擾ｽｳ陝ｾ譎画＝,隴擾ｽｭ陷･�ｽ,10,1935,,768416,370907,397509
驕紋ｸ茨ｽｺ諷墓＝,隴擾ｽｭ陷･�ｽ,10,1935,,646659,316424,330235
陞ｻ�ｱ隴ｴ�ｨ騾ｵ�ｽ,隴擾ｽｭ陷･�ｽ,10,1935,,646727,319924,326803
鬮滂ｽｷ鬩･螳域＝,隴擾ｽｭ陷･�ｽ,10,1935,,1714000,840103,873897
陝ｯ螳｣�ｽ騾ｵ�ｽ,隴擾ｽｭ陷･�ｽ,10,1935,,1225799,612366,613433
鬮ｱ蜷晢ｽｲ�｡騾ｵ�ｽ,隴擾ｽｭ陷･�ｽ,10,1935,,1939860,966250,973610
隲｢蟶ｷ陦埼ｵ�ｽ,隴擾ｽｭ陷･�ｽ,10,1935,,2862701,1418218,1444483
闕ｳ陋ｾ纃ｾ騾ｵ�ｽ,隴擾ｽｭ陷･�ｽ,10,1935,,1174595,572356,602239
雋顔事�ｳﾂ騾ｵ�ｽ,隴擾ｽｭ陷･�ｽ,10,1935,,711436,345185,366251
闔��ｬ鬩幢ｽｽ陟趣ｿｽ,隴擾ｽｭ陷･�ｽ,10,1935,,1702508,862998,839510
陞滂ｽｧ鬮ｦ�ｪ陟趣ｿｽ,隴擾ｽｭ陷･�ｽ,10,1935,,4297174,2241666,2055508
陷茨ｽｵ陟趣ｽｫ騾ｵ�ｽ,隴擾ｽｭ陷･�ｽ,10,1935,,2923249,1466284,1456965
陞るメ諞ｶ騾ｵ�ｽ,隴擾ｽｭ陷･�ｽ,10,1935,,620471,306011,314460
陷･譴ｧ�ｭ謔滂ｽｱ�ｱ騾ｵ�ｽ,隴擾ｽｭ陷･�ｽ,10,1935,,864087,428638,435449
鬲托ｽ･陷ｿ荵滓＝,隴擾ｽｭ陷･�ｽ,10,1935,,490461,239301,251160
陝ｲ�ｶ隴ｬ�ｹ騾ｵ�ｽ,隴擾ｽｭ陷･�ｽ,10,1935,,747119,373292,373827
陝ｯ�｡陞ｻ�ｱ騾ｵ�ｽ,隴擾ｽｭ陷･�ｽ,10,1935,,1332647,658773,673874
陟趣ｿｽ�ｳ�ｶ騾ｵ�ｽ,隴擾ｽｭ陷･�ｽ,10,1935,,1804916,914185,890731
陞ｻ�ｱ陷ｿ�｣騾ｵ�ｽ,隴擾ｽｭ陷･�ｽ,10,1935,,1190542,598434,592108
陟包ｽｳ陝ｲ�ｶ騾ｵ�ｽ,隴擾ｽｭ陷･�ｽ,10,1935,,728748,362042,366706
鬯･蜷晢ｽｷ譎画＝,隴擾ｽｭ陷･�ｽ,10,1935,,748656,373522,375134
隲｢蟶幢ｽｪ蟶ｷ諱�,隴擾ｽｭ陷･�ｽ,10,1935,,1164898,575627,589271
鬯ｮ蛟｡陦埼ｵ�ｽ,隴擾ｽｭ陷･�ｽ,10,1935,,714980,355225,359755
驕紋ｸ橸ｽｲ�｡騾ｵ�ｽ,隴擾ｽｭ陷･�ｽ,10,1935,,2755804,1392799,1363005
闖ｴ蜊��ｳﾂ騾ｵ�ｽ,隴擾ｽｭ陷･�ｽ,10,1935,,686117,332764,353353
鬮滂ｽｷ陝�螳域＝,隴擾ｽｭ陷･�ｽ,10,1935,,1296883,662174,634709
霎ｭ鬆第た騾ｵ�ｽ,隴擾ｽｭ陷･�ｽ,10,1935,,1387054,680409,706645
陞滂ｽｧ陋ｻ�ｽ諱�,隴擾ｽｭ陷･�ｽ,10,1935,,980458,481549,498909
陞ｳ�ｮ陝�螳域＝,隴擾ｽｭ陷･�ｽ,10,1935,,824431,416082,408349
魄厄ｽｿ陷井ｻ呻ｽｳ�ｶ騾ｵ�ｽ,隴擾ｽｭ陷･�ｽ,10,1935,,1591466,773126,818340
雎蝉ｹ滂ｽｸ�ｽ諱�,隴擾ｽｭ陷･�ｽ,10,1935,,592494,281266,311228
陷茨ｽｨ陜暦ｽｽ,隴擾ｽｭ陷･�ｽ,15,1940,,73114308,36566010,36548298
陋ｹ邇ｲ�ｵ�ｷ鬩包ｿｽ,隴擾ｽｭ陷･�ｽ,15,1940,,3272718,1695600,1577118
鬮ｱ蜻茨ｽ｣�ｮ騾ｵ�ｽ,隴擾ｽｭ陷･�ｽ,15,1940,,1000509,496614,503895
陝ｯ�ｩ隰�距諱�,隴擾ｽｭ陷･�ｽ,15,1940,,1095793,544276,551517
陞ｳ�ｮ陜灘ｮ域＝,隴擾ｽｭ陷･�ｽ,15,1940,,1271238,637888,633350
驕倡距莨宣ｵ�ｽ,隴擾ｽｭ陷･�ｽ,15,1940,,1052275,524018,528257
陞ｻ�ｱ陟厄ｽ｢騾ｵ�ｽ,隴擾ｽｭ陷･�ｽ,15,1940,,1119338,548404,570934
驕紋ｸ橸ｽｳ�ｶ騾ｵ�ｽ,隴擾ｽｭ陷･�ｽ,15,1940,,1625521,799788,825733
髣鯉ｽｨ陜灘ｮ域＝,隴擾ｽｭ陷･�ｽ,15,1940,,1620000,801914,818086
隴ｬ�ｽ諠�騾ｵ�ｽ,隴擾ｽｭ陷･�ｽ,15,1940,,1206657,591599,615058
驗抵ｽ､鬯･�ｬ騾ｵ�ｽ,隴擾ｽｭ陷･�ｽ,15,1940,,1299027,637708,661319
陜難ｽｼ驍��諱�,隴擾ｽｭ陷･�ｽ,15,1940,,1608039,798321,809718
陷奇ｿｽ逞ｩ騾ｵ�ｽ,隴擾ｽｭ陷･�ｽ,15,1940,,1588425,776541,811884
隴夲ｽｱ闔��ｬ鬩幢ｽｽ,隴擾ｽｭ陷･�ｽ,15,1940,,7354971,3795875,3559096
騾ｾ讒ｫ�･莠･�ｷ譎画＝,隴擾ｽｭ陷･�ｽ,15,1940,,2188974,1137936,1051038
隴�ｽｰ雋取ｺｽ諱�,隴擾ｽｭ陷･�ｽ,15,1940,,2064402,1017080,1047322
陝�ぁ�ｱ�ｱ騾ｵ�ｽ,隴擾ｽｭ陷･�ｽ,15,1940,,822569,401261,421308
驕擾ｽｳ陝ｾ譎画＝,隴擾ｽｭ陷･�ｽ,15,1940,,757676,363922,393754
驕紋ｸ茨ｽｺ諷墓＝,隴擾ｽｭ陷･�ｽ,15,1940,,643904,312075,331829
陞ｻ�ｱ隴ｴ�ｨ騾ｵ�ｽ,隴擾ｽｭ陷･�ｽ,15,1940,,663026,328056,334970
鬮滂ｽｷ鬩･螳域＝,隴擾ｽｭ陷･�ｽ,15,1940,,1710729,833987,876742
陝ｯ螳｣�ｽ騾ｵ�ｽ,隴擾ｽｭ陷･�ｽ,15,1940,,1265024,632820,632204
鬮ｱ蜷晢ｽｲ�｡騾ｵ�ｽ,隴擾ｽｭ陷･�ｽ,15,1940,,2017860,996813,1021047
隲｢蟶ｷ陦埼ｵ�ｽ,隴擾ｽｭ陷･�ｽ,15,1940,,3166592,1582580,1584012
闕ｳ陋ｾ纃ｾ騾ｵ�ｽ,隴擾ｽｭ陷･�ｽ,15,1940,,1198783,585427,613356
雋顔事�ｳﾂ騾ｵ�ｽ,隴擾ｽｭ陷･�ｽ,15,1940,,703679,341631,362048
闔��ｬ鬩幢ｽｽ陟趣ｿｽ,隴擾ｽｭ陷･�ｽ,15,1940,,1729993,863494,866499
陞滂ｽｧ鬮ｦ�ｪ陟趣ｿｽ,隴擾ｽｭ陷･�ｽ,15,1940,,4792966,2460574,2332392
陷茨ｽｵ陟趣ｽｫ騾ｵ�ｽ,隴擾ｽｭ陷･�ｽ,15,1940,,3221232,1622778,1598454
陞るメ諞ｶ騾ｵ�ｽ,隴擾ｽｭ陷･�ｽ,15,1940,,620509,305681,314828
陷･譴ｧ�ｭ謔滂ｽｱ�ｱ騾ｵ�ｽ,隴擾ｽｭ陷･�ｽ,15,1940,,865074,427217,437857
鬲托ｽ･陷ｿ荵滓＝,隴擾ｽｭ陷･�ｽ,15,1940,,484390,233964,250426
陝ｲ�ｶ隴ｬ�ｹ騾ｵ�ｽ,隴擾ｽｭ陷･�ｽ,15,1940,,740940,367855,373085
陝ｯ�｡陞ｻ�ｱ騾ｵ�ｽ,隴擾ｽｭ陷･�ｽ,15,1940,,1329358,651197,678161
陟趣ｿｽ�ｳ�ｶ騾ｵ�ｽ,隴擾ｽｭ陷･�ｽ,15,1940,,1869504,936936,932568
陞ｻ�ｱ陷ｿ�｣騾ｵ�ｽ,隴擾ｽｭ陷･�ｽ,15,1940,,1294242,658265,635977
陟包ｽｳ陝ｲ�ｶ騾ｵ�ｽ,隴擾ｽｭ陷･�ｽ,15,1940,,718717,354423,364294
鬯･蜷晢ｽｷ譎画＝,隴擾ｽｭ陷･�ｽ,15,1940,,730394,359139,371255
隲｢蟶幢ｽｪ蟶ｷ諱�,隴擾ｽｭ陷･�ｽ,15,1940,,1178705,580839,597866
鬯ｮ蛟｡陦埼ｵ�ｽ,隴擾ｽｭ陷･�ｽ,15,1940,,709286,348907,360379
驕紋ｸ橸ｽｲ�｡騾ｵ�ｽ,隴擾ｽｭ陷･�ｽ,15,1940,,3094132,1577063,1517069
闖ｴ蜊��ｳﾂ騾ｵ�ｽ,隴擾ｽｭ陷･�ｽ,15,1940,,701517,343047,358470
鬮滂ｽｷ陝�螳域＝,隴擾ｽｭ陷･�ｽ,15,1940,,1370063,698627,671436
霎ｭ鬆第た騾ｵ�ｽ,隴擾ｽｭ陷･�ｽ,15,1940,,1368179,666886,701293
陞滂ｽｧ陋ｻ�ｽ諱�,隴擾ｽｭ陷･�ｽ,15,1940,,972975,473521,499454
陞ｳ�ｮ陝�螳域＝,隴擾ｽｭ陷･�ｽ,15,1940,,840357,417180,423177
魄厄ｽｿ陷井ｻ呻ｽｳ�ｶ騾ｵ�ｽ,隴擾ｽｭ陷･�ｽ,15,1940,,1589467,765603,823864
雎蝉ｹ滂ｽｸ�ｽ諱�,隴擾ｽｭ陷･�ｽ,15,1940,,574579,270680,303899
陷茨ｽｨ陜暦ｽｽ,隴擾ｽｭ陷･�ｽ,20,1945,1),71998104,33894059,38104045
陋ｹ邇ｲ�ｵ�ｷ鬩包ｿｽ,隴擾ｽｭ陷･�ｽ,20,1945,1),3518389,1738623,1779766
鬮ｱ蜻茨ｽ｣�ｮ騾ｵ�ｽ,隴擾ｽｭ陷･�ｽ,20,1945,1),1083250,511798,571452
陝ｯ�ｩ隰�距諱�,隴擾ｽｭ陷･�ｽ,20,1945,1),1227789,579741,648048
陞ｳ�ｮ陜灘ｮ域＝,隴擾ｽｭ陷･�ｽ,20,1945,1),1462254,684453,777801
驕倡距莨宣ｵ�ｽ,隴擾ｽｭ陷･�ｽ,20,1945,1),1211871,574732,637139
陞ｻ�ｱ陟厄ｽ｢騾ｵ�ｽ,隴擾ｽｭ陷･�ｽ,20,1945,1),1326350,612300,714050
驕紋ｸ橸ｽｳ�ｶ騾ｵ�ｽ,隴擾ｽｭ陷･�ｽ,20,1945,1),1957356,906765,1050591
髣鯉ｽｨ陜灘ｮ域＝,隴擾ｽｭ陷･�ｽ,20,1945,1),1944344,907525,1036819
隴ｬ�ｽ諠�騾ｵ�ｽ,隴擾ｽｭ陷･�ｽ,20,1945,1),1546355,719529,826826
驗抵ｽ､鬯･�ｬ騾ｵ�ｽ,隴擾ｽｭ陷･�ｽ,20,1945,1),1546081,723804,822277
陜難ｽｼ驍��諱�,隴擾ｽｭ陷･�ｽ,20,1945,1),2047261,955753,1091508
陷奇ｿｽ逞ｩ騾ｵ�ｽ,隴擾ｽｭ陷･�ｽ,20,1945,1),1966862,908228,1058634
隴夲ｽｱ闔��ｬ鬩幢ｽｽ,隴擾ｽｭ陷･�ｽ,20,1945,1),3488284,1788145,1700139
騾ｾ讒ｫ�･莠･�ｷ譎画＝,隴擾ｽｭ陷･�ｽ,20,1945,1),1865667,922522,943145
隴�ｽｰ雋取ｺｽ諱�,隴擾ｽｭ陷･�ｽ,20,1945,1),2389653,1095809,1293844
陝�ぁ�ｱ�ｱ騾ｵ�ｽ,隴擾ｽｭ陷･�ｽ,20,1945,1),953834,442490,511344
驕擾ｽｳ陝ｾ譎画＝,隴擾ｽｭ陷･�ｽ,20,1945,1),887510,405264,482246
驕紋ｸ茨ｽｺ諷墓＝,隴擾ｽｭ陷･�ｽ,20,1945,1),724856,332461,392395
陞ｻ�ｱ隴ｴ�ｨ騾ｵ�ｽ,隴擾ｽｭ陷･�ｽ,20,1945,1),839057,384255,454802
鬮滂ｽｷ鬩･螳域＝,隴擾ｽｭ陷･�ｽ,20,1945,1),2121050,973871,1147179
陝ｯ螳｣�ｽ騾ｵ�ｽ,隴擾ｽｭ陷･�ｽ,20,1945,1),1518649,715800,802849
鬮ｱ蜷晢ｽｲ�｡騾ｵ�ｽ,隴擾ｽｭ陷･�ｽ,20,1945,1),2220358,1039175,1181183
隲｢蟶ｷ陦埼ｵ�ｽ,隴擾ｽｭ陷･�ｽ,20,1945,1),2857851,1357054,1500797
闕ｳ陋ｾ纃ｾ騾ｵ�ｽ,隴擾ｽｭ陷･�ｽ,20,1945,1),1394286,646954,747332
雋顔事�ｳﾂ騾ｵ�ｽ,隴擾ｽｭ陷･�ｽ,20,1945,1),860911,394802,466109
闔��ｬ鬩幢ｽｽ陟趣ｿｽ,隴擾ｽｭ陷･�ｽ,20,1945,1),1603796,752494,851302
陞滂ｽｧ鬮ｦ�ｪ陟趣ｿｽ,隴擾ｽｭ陷･�ｽ,20,1945,1),2800958,1353776,1447182
陷茨ｽｵ陟趣ｽｫ騾ｵ�ｽ,隴擾ｽｭ陷･�ｽ,20,1945,1),2821892,1344778,1477114
陞るメ諞ｶ騾ｵ�ｽ,隴擾ｽｭ陷･�ｽ,20,1945,1),779685,355351,424334
陷･譴ｧ�ｭ謔滂ｽｱ�ｱ騾ｵ�ｽ,隴擾ｽｭ陷･�ｽ,20,1945,1),936006,430015,505991
鬲托ｽ･陷ｿ荵滓＝,隴擾ｽｭ陷･�ｽ,20,1945,1),563220,255525,307695
陝ｲ�ｶ隴ｬ�ｹ騾ｵ�ｽ,隴擾ｽｭ陷･�ｽ,20,1945,1),860275,395360,464915
陝ｯ�｡陞ｻ�ｱ騾ｵ�ｽ,隴擾ｽｭ陷･�ｽ,20,1945,1),1564626,728314,836312
陟趣ｿｽ�ｳ�ｶ騾ｵ�ｽ,隴擾ｽｭ陷･�ｽ,20,1945,1),1885471,878343,1007128
陞ｻ�ｱ陷ｿ�｣騾ｵ�ｽ,隴擾ｽｭ陷･�ｽ,20,1945,1),1356491,638167,718324
陟包ｽｳ陝ｲ�ｶ騾ｵ�ｽ,隴擾ｽｭ陷･�ｽ,20,1945,1),835763,386052,449711
鬯･蜷晢ｽｷ譎画＝,隴擾ｽｭ陷･�ｽ,20,1945,1),863700,396235,467465
隲｢蟶幢ｽｪ蟶ｷ諱�,隴擾ｽｭ陷･�ｽ,20,1945,1),1361484,635305,726179
鬯ｮ蛟｡陦埼ｵ�ｽ,隴擾ｽｭ陷･�ｽ,20,1945,1),775578,357940,417638
驕紋ｸ橸ｽｲ�｡騾ｵ�ｽ,隴擾ｽｭ陷･�ｽ,20,1945,1),2746855,1304677,1442178
闖ｴ蜊��ｳﾂ騾ｵ�ｽ,隴擾ｽｭ陷･�ｽ,20,1945,1),830431,379361,451070
鬮滂ｽｷ陝�螳域＝,隴擾ｽｭ陷･�ｽ,20,1945,1),1318589,618861,699728
霎ｭ鬆第た騾ｵ�ｽ,隴擾ｽｭ陷･�ｽ,20,1945,1),1556490,715526,840964
陞滂ｽｧ陋ｻ�ｽ諱�,隴擾ｽｭ陷･�ｽ,20,1945,1),1124513,520470,604043
陞ｳ�ｮ陝�螳域＝,隴擾ｽｭ陷･�ｽ,20,1945,1),913687,426201,487486
魄厄ｽｿ陷井ｻ呻ｽｳ�ｶ騾ｵ�ｽ,隴擾ｽｭ陷･�ｽ,20,1945,1),1538466,699455,839011
陷茨ｽｨ陜暦ｽｽ,隴擾ｽｭ陷･�ｽ,25,1950,,84114574,41241192,42873382
陋ｹ邇ｲ�ｵ�ｷ鬩包ｿｽ,隴擾ｽｭ陷･�ｽ,25,1950,,4295567,2169393,2126174
鬮ｱ蜻茨ｽ｣�ｮ騾ｵ�ｽ,隴擾ｽｭ陷･�ｽ,25,1950,,1282867,635547,647320
陝ｯ�ｩ隰�距諱�,隴擾ｽｭ陷･�ｽ,25,1950,,1346728,664000,682728
陞ｳ�ｮ陜灘ｮ域＝,隴擾ｽｭ陷･�ｽ,25,1950,,1663442,828879,834563
驕倡距莨宣ｵ�ｽ,隴擾ｽｭ陷･�ｽ,25,1950,,1309031,646445,662586
陞ｻ�ｱ陟厄ｽ｢騾ｵ�ｽ,隴擾ｽｭ陷･�ｽ,25,1950,,1357347,660555,696792
驕紋ｸ橸ｽｳ�ｶ騾ｵ�ｽ,隴擾ｽｭ陷･�ｽ,25,1950,,2062394,1006823,1055571
髣鯉ｽｨ陜灘ｮ域＝,隴擾ｽｭ陷･�ｽ,25,1950,,2039418,993694,1045724
隴ｬ�ｽ諠�騾ｵ�ｽ,隴擾ｽｭ陷･�ｽ,25,1950,,1550462,752266,798196
驗抵ｽ､鬯･�ｬ騾ｵ�ｽ,隴擾ｽｭ陷･�ｽ,25,1950,,1601380,778910,822470
陜難ｽｼ驍��諱�,隴擾ｽｭ陷･�ｽ,25,1950,,2146445,1049695,1096750
陷奇ｿｽ逞ｩ騾ｵ�ｽ,隴擾ｽｭ陷･�ｽ,25,1950,,2139037,1036932,1102105
隴夲ｽｱ闔��ｬ鬩幢ｽｽ,隴擾ｽｭ陷･�ｽ,25,1950,,6277500,3169389,3108111
騾ｾ讒ｫ�･莠･�ｷ譎画＝,隴擾ｽｭ陷･�ｽ,25,1950,,2487665,1247934,1239731
隴�ｽｰ雋取ｺｽ諱�,隴擾ｽｭ陷･�ｽ,25,1950,,2460997,1194929,1266068
陝�ぁ�ｱ�ｱ騾ｵ�ｽ,隴擾ｽｭ陷･�ｽ,25,1950,,1008790,488850,519940
驕擾ｽｳ陝ｾ譎画＝,隴擾ｽｭ陷･�ｽ,25,1950,,957279,460859,496420
驕紋ｸ茨ｽｺ諷墓＝,隴擾ｽｭ陷･�ｽ,25,1950,,752374,364343,388031
陞ｻ�ｱ隴ｴ�ｨ騾ｵ�ｽ,隴擾ｽｭ陷･�ｽ,25,1950,,811369,393550,417819
鬮滂ｽｷ鬩･螳域＝,隴擾ｽｭ陷･�ｽ,25,1950,,2060831,1001192,1059639
陝ｯ螳｣�ｽ騾ｵ�ｽ,隴擾ｽｭ陷･�ｽ,25,1950,,1544538,762295,782243
鬮ｱ蜷晢ｽｲ�｡騾ｵ�ｽ,隴擾ｽｭ陷･�ｽ,25,1950,,2471472,1206651,1264821
隲｢蟶ｷ陦埼ｵ�ｽ,隴擾ｽｭ陷･�ｽ,25,1950,,3390585,1649189,1741396
闕ｳ陋ｾ纃ｾ騾ｵ�ｽ,隴擾ｽｭ陷･�ｽ,25,1950,,1461197,704805,756392
雋顔事�ｳﾂ騾ｵ�ｽ,隴擾ｽｭ陷･�ｽ,25,1950,,861180,413110,448070
闔��ｬ鬩幢ｽｽ陟趣ｿｽ,隴擾ｽｭ陷･�ｽ,25,1950,,1832934,891616,941318
陞滂ｽｧ鬮ｦ�ｪ陟趣ｿｽ,隴擾ｽｭ陷･�ｽ,25,1950,,3857047,1899745,1957302
陷茨ｽｵ陟趣ｽｫ騾ｵ�ｽ,隴擾ｽｭ陷･�ｽ,25,1950,,3309935,1622755,1687180
陞るメ諞ｶ騾ｵ�ｽ,隴擾ｽｭ陷･�ｽ,25,1950,,763883,368863,395020
陷･譴ｧ�ｭ謔滂ｽｱ�ｱ騾ｵ�ｽ,隴擾ｽｭ陷･�ｽ,25,1950,,982113,475324,506789
鬲托ｽ･陷ｿ荵滓＝,隴擾ｽｭ陷･�ｽ,25,1950,,600177,289787,310390
陝ｲ�ｶ隴ｬ�ｹ騾ｵ�ｽ,隴擾ｽｭ陷･�ｽ,25,1950,,912551,444355,468196
陝ｯ�｡陞ｻ�ｱ騾ｵ�ｽ,隴擾ｽｭ陷･�ｽ,25,1950,,1661099,804357,856742
陟趣ｿｽ�ｳ�ｶ騾ｵ�ｽ,隴擾ｽｭ陷･�ｽ,25,1950,,2081967,1015955,1066012
陞ｻ�ｱ陷ｿ�｣騾ｵ�ｽ,隴擾ｽｭ陷･�ｽ,25,1950,,1540882,760220,780662
陟包ｽｳ陝ｲ�ｶ騾ｵ�ｽ,隴擾ｽｭ陷･�ｽ,25,1950,,878511,427684,450827
鬯･蜷晢ｽｷ譎画＝,隴擾ｽｭ陷･�ｽ,25,1950,,946022,457980,488042
隲｢蟶幢ｽｪ蟶ｷ諱�,隴擾ｽｭ陷･�ｽ,25,1950,,1521878,742092,779786
鬯ｮ蛟｡陦埼ｵ�ｽ,隴擾ｽｭ陷･�ｽ,25,1950,,873874,425968,447906
驕紋ｸ橸ｽｲ�｡騾ｵ�ｽ,隴擾ｽｭ陷･�ｽ,25,1950,,3530169,1745606,1784563
闖ｴ蜊��ｳﾂ騾ｵ�ｽ,隴擾ｽｭ陷･�ｽ,25,1950,,945082,455824,489258
鬮滂ｽｷ陝�螳域＝,隴擾ｽｭ陷･�ｽ,25,1950,,1645492,812079,833413
霎ｭ鬆第た騾ｵ�ｽ,隴擾ｽｭ陷･�ｽ,25,1950,,1827582,882420,945162
陞滂ｽｧ陋ｻ�ｽ諱�,隴擾ｽｭ陷･�ｽ,25,1950,,1252999,604825,648174
陞ｳ�ｮ陝�螳域＝,隴擾ｽｭ陷･�ｽ,25,1950,,1091427,535107,556320
魄厄ｽｿ陷井ｻ呻ｽｳ�ｶ騾ｵ�ｽ,隴擾ｽｭ陷･�ｽ,25,1950,,1804118,868963,935155
雎蝉ｹ滂ｽｸ�ｽ諱�,隴擾ｽｭ陷･�ｽ,25,1950,,914937,429432,485505
陷茨ｽｨ陜暦ｽｽ,隴擾ｽｭ陷･�ｽ,30,1955,,90076594,44242657,45833937
陋ｹ邇ｲ�ｵ�ｷ鬩包ｿｽ,隴擾ｽｭ陷･�ｽ,30,1955,,4773087,2428833,2344254
鬮ｱ蜻茨ｽ｣�ｮ騾ｵ�ｽ,隴擾ｽｭ陷･�ｽ,30,1955,,1382523,678837,703686
陝ｯ�ｩ隰�距諱�,隴擾ｽｭ陷･�ｽ,30,1955,,1427097,698563,728534
陞ｳ�ｮ陜灘ｮ域＝,隴擾ｽｭ陷･�ｽ,30,1955,,1727065,846404,880661
驕倡距莨宣ｵ�ｽ,隴擾ｽｭ陷･�ｽ,30,1955,,1348871,660066,688805
陞ｻ�ｱ陟厄ｽ｢騾ｵ�ｽ,隴擾ｽｭ陷･�ｽ,30,1955,,1353649,651737,701912
驕紋ｸ橸ｽｳ�ｶ騾ｵ�ｽ,隴擾ｽｭ陷･�ｽ,30,1955,,2095237,1016756,1078481
髣鯉ｽｨ陜灘ｮ域＝,隴擾ｽｭ陷･�ｽ,30,1955,,2064037,1006093,1057944
隴ｬ�ｽ諠�騾ｵ�ｽ,隴擾ｽｭ陷･�ｽ,30,1955,,1547580,749636,797944
驗抵ｽ､鬯･�ｬ騾ｵ�ｽ,隴擾ｽｭ陷･�ｽ,30,1955,,1613549,781607,831942
陜難ｽｼ驍��諱�,隴擾ｽｭ陷･�ｽ,30,1955,,2262623,1110083,1152540
陷奇ｿｽ逞ｩ騾ｵ�ｽ,隴擾ｽｭ陷･�ｽ,30,1955,,2205060,1074181,1130879
隴夲ｽｱ闔��ｬ鬩幢ｽｽ,隴擾ｽｭ陷･�ｽ,30,1955,,8037084,4115823,3921261
騾ｾ讒ｫ�･莠･�ｷ譎画＝,隴擾ｽｭ陷･�ｽ,30,1955,,2919497,1470415,1449082
隴�ｽｰ雋取ｺｽ諱�,隴擾ｽｭ陷･�ｽ,30,1955,,2473492,1195872,1277620
陝�ぁ�ｱ�ｱ騾ｵ�ｽ,隴擾ｽｭ陷･�ｽ,30,1955,,1021121,494109,527012
驕擾ｽｳ陝ｾ譎画＝,隴擾ｽｭ陷･�ｽ,30,1955,,966187,463477,502710
驕紋ｸ茨ｽｺ諷墓＝,隴擾ｽｭ陷･�ｽ,30,1955,,754055,363770,390285
陞ｻ�ｱ隴ｴ�ｨ騾ｵ�ｽ,隴擾ｽｭ陷･�ｽ,30,1955,,807044,390205,416839
鬮滂ｽｷ鬩･螳域＝,隴擾ｽｭ陷･�ｽ,30,1955,,2021292,979004,1042288
陝ｯ螳｣�ｽ騾ｵ�ｽ,隴擾ｽｭ陷･�ｽ,30,1955,,1583605,774062,809543
鬮ｱ蜷晢ｽｲ�｡騾ｵ�ｽ,隴擾ｽｭ陷･�ｽ,30,1955,,2650435,1301198,1349237
隲｢蟶ｷ陦埼ｵ�ｽ,隴擾ｽｭ陷･�ｽ,30,1955,,3769209,1829729,1939480
闕ｳ陋ｾ纃ｾ騾ｵ�ｽ,隴擾ｽｭ陷･�ｽ,30,1955,,1485582,717819,767763
雋顔事�ｳﾂ騾ｵ�ｽ,隴擾ｽｭ陷･�ｽ,30,1955,,853734,409813,443921
闔��ｬ鬩幢ｽｽ陟趣ｿｽ,隴擾ｽｭ陷･�ｽ,30,1955,,1935161,944278,990883
陞滂ｽｧ鬮ｦ�ｪ陟趣ｿｽ,隴擾ｽｭ陷･�ｽ,30,1955,,4618308,2290170,2328138
陷茨ｽｵ陟趣ｽｫ騾ｵ�ｽ,隴擾ｽｭ陷･�ｽ,30,1955,,3620947,1773488,1847459
陞るメ諞ｶ騾ｵ�ｽ,隴擾ｽｭ陷･�ｽ,30,1955,,776861,377961,398900
陷･譴ｧ�ｭ謔滂ｽｱ�ｱ騾ｵ�ｽ,隴擾ｽｭ陷･�ｽ,30,1955,,1006819,490533,516286
鬲托ｽ･陷ｿ荵滓＝,隴擾ｽｭ陷･�ｽ,30,1955,,614259,297015,317244
陝ｲ�ｶ隴ｬ�ｹ騾ｵ�ｽ,隴擾ｽｭ陷･�ｽ,30,1955,,929066,456730,472336
陝ｯ�｡陞ｻ�ｱ騾ｵ�ｽ,隴擾ｽｭ陷･�ｽ,30,1955,,1689800,815837,873963
陟趣ｿｽ�ｳ�ｶ騾ｵ�ｽ,隴擾ｽｭ陷･�ｽ,30,1955,,2149044,1047184,1101860
陞ｻ�ｱ陷ｿ�｣騾ｵ�ｽ,隴擾ｽｭ陷･�ｽ,30,1955,,1609839,792546,817293
陟包ｽｳ陝ｲ�ｶ騾ｵ�ｽ,隴擾ｽｭ陷･�ｽ,30,1955,,878109,427204,450905
鬯･蜷晢ｽｷ譎画＝,隴擾ｽｭ陷･�ｽ,30,1955,,943823,456711,487112
隲｢蟶幢ｽｪ蟶ｷ諱�,隴擾ｽｭ陷･�ｽ,30,1955,,1540628,749342,791286
鬯ｮ蛟｡陦埼ｵ�ｽ,隴擾ｽｭ陷･�ｽ,30,1955,,882683,429175,453508
驕紋ｸ橸ｽｲ�｡騾ｵ�ｽ,隴擾ｽｭ陷･�ｽ,30,1955,,3859764,1895365,1964399
闖ｴ蜊��ｳﾂ騾ｵ�ｽ,隴擾ｽｭ陷･�ｽ,30,1955,,973749,470437,503312
鬮滂ｽｷ陝�螳域＝,隴擾ｽｭ陷･�ｽ,30,1955,,1747596,859689,887907
霎ｭ鬆第た騾ｵ�ｽ,隴擾ｽｭ陷･�ｽ,30,1955,,1895663,917171,978492
陞滂ｽｧ陋ｻ�ｽ諱�,隴擾ｽｭ陷･�ｽ,30,1955,,1277199,616402,660797
陞ｳ�ｮ陝�螳域＝,隴擾ｽｭ陷･�ｽ,30,1955,,1139384,559771,579613
魄厄ｽｿ陷井ｻ呻ｽｳ�ｶ騾ｵ�ｽ,隴擾ｽｭ陷･�ｽ,30,1955,,2044112,985617,1058495
雎蝉ｹ滂ｽｸ�ｽ諱�,隴擾ｽｭ陷･�ｽ,30,1955,,801065,381939,419126
陷茨ｽｨ陜暦ｽｽ,隴擾ｽｭ陷･�ｽ,35,1960,2),94301623,46300445,48001178
陋ｹ邇ｲ�ｵ�ｷ鬩包ｿｽ,隴擾ｽｭ陷･�ｽ,35,1960,2),5039206,2544753,2494453
鬮ｱ蜻茨ｽ｣�ｮ騾ｵ�ｽ,隴擾ｽｭ陷･�ｽ,35,1960,2),1426606,694037,732569
陝ｯ�ｩ隰�距諱�,隴擾ｽｭ陷･�ｽ,35,1960,2),1448517,702697,745820
陞ｳ�ｮ陜灘ｮ域＝,隴擾ｽｭ陷･�ｽ,35,1960,2),1743195,848579,894616
驕倡距莨宣ｵ�ｽ,隴擾ｽｭ陷･�ｽ,35,1960,2),1335580,644671,690909
陞ｻ�ｱ陟厄ｽ｢騾ｵ�ｽ,隴擾ｽｭ陷･�ｽ,35,1960,2),1320664,630997,689667
驕紋ｸ橸ｽｳ�ｶ騾ｵ�ｽ,隴擾ｽｭ陷･�ｽ,35,1960,2),2051137,986836,1064301
髣鯉ｽｨ陜灘ｮ域＝,隴擾ｽｭ陷･�ｽ,35,1960,2),2047024,1000184,1046840
隴ｬ�ｽ諠�騾ｵ�ｽ,隴擾ｽｭ陷･�ｽ,35,1960,2),1513624,729692,783932
驗抵ｽ､鬯･�ｬ騾ｵ�ｽ,隴擾ｽｭ陷･�ｽ,35,1960,2),1578476,759639,818837
陜難ｽｼ驍��諱�,隴擾ｽｭ陷･�ｽ,35,1960,2),2430871,1200573,1230298
陷奇ｿｽ逞ｩ騾ｵ�ｽ,隴擾ｽｭ陷･�ｽ,35,1960,2),2306010,1128734,1177276
隴夲ｽｱ闔��ｬ鬩幢ｽｽ,隴擾ｽｭ陷･�ｽ,35,1960,2),9683802,4997023,4686779
騾ｾ讒ｫ�･莠･�ｷ譎画＝,隴擾ｽｭ陷･�ｽ,35,1960,2),3443176,1746926,1696250
隴�ｽｰ雋取ｺｽ諱�,隴擾ｽｭ陷･�ｽ,35,1960,2),2442037,1177923,1264114
陝�ぁ�ｱ�ｱ騾ｵ�ｽ,隴擾ｽｭ陷･�ｽ,35,1960,2),1032614,500545,532069
驕擾ｽｳ陝ｾ譎画＝,隴擾ｽｭ陷･�ｽ,35,1960,2),973418,464889,508529
驕紋ｸ茨ｽｺ諷墓＝,隴擾ｽｭ陷･�ｽ,35,1960,2),752696,360288,392408
陞ｻ�ｱ隴ｴ�ｨ騾ｵ�ｽ,隴擾ｽｭ陷･�ｽ,35,1960,2),782062,379057,403005
鬮滂ｽｷ鬩･螳域＝,隴擾ｽｭ陷･�ｽ,35,1960,2),1981433,954673,1026760
陝ｯ螳｣�ｽ騾ｵ�ｽ,隴擾ｽｭ陷･�ｽ,35,1960,2),1638399,796825,841574
鬮ｱ蜷晢ｽｲ�｡騾ｵ�ｽ,隴擾ｽｭ陷･�ｽ,35,1960,2),2756271,1353122,1403149
隲｢蟶ｷ陦埼ｵ�ｽ,隴擾ｽｭ陷･�ｽ,35,1960,2),4206313,2064726,2141587
闕ｳ陋ｾ纃ｾ騾ｵ�ｽ,隴擾ｽｭ陷･�ｽ,35,1960,2),1485054,716715,768339
雋顔事�ｳﾂ騾ｵ�ｽ,隴擾ｽｭ陷･�ｽ,35,1960,2),842695,403281,439414
闔��ｬ鬩幢ｽｽ陟趣ｿｽ,隴擾ｽｭ陷･�ｽ,35,1960,2),1993403,973040,1020363
陞滂ｽｧ鬮ｦ�ｪ陟趣ｿｽ,隴擾ｽｭ陷･�ｽ,35,1960,2),5504746,2766229,2738517
陷茨ｽｵ陟趣ｽｫ騾ｵ�ｽ,隴擾ｽｭ陷･�ｽ,35,1960,2),3906487,1917887,1988600
陞るメ諞ｶ騾ｵ�ｽ,隴擾ｽｭ陷･�ｽ,35,1960,2),781058,382494,398564
陷･譴ｧ�ｭ謔滂ｽｱ�ｱ騾ｵ�ｽ,隴擾ｽｭ陷･�ｽ,35,1960,2),1002191,484994,517197
鬲托ｽ･陷ｿ荵滓＝,隴擾ｽｭ陷･�ｽ,35,1960,2),599135,286716,312419
陝ｲ�ｶ隴ｬ�ｹ騾ｵ�ｽ,隴擾ｽｭ陷･�ｽ,35,1960,2),888886,432481,456405
陝ｯ�｡陞ｻ�ｱ騾ｵ�ｽ,隴擾ｽｭ陷･�ｽ,35,1960,2),1670454,797748,872706
陟趣ｿｽ�ｳ�ｶ騾ｵ�ｽ,隴擾ｽｭ陷･�ｽ,35,1960,2),2184043,1058829,1125214
陞ｻ�ｱ陷ｿ�｣騾ｵ�ｽ,隴擾ｽｭ陷･�ｽ,35,1960,2),1602207,780439,821768
陟包ｽｳ陝ｲ�ｶ騾ｵ�ｽ,隴擾ｽｭ陷･�ｽ,35,1960,2),847274,408300,438974
鬯･蜷晢ｽｷ譎画＝,隴擾ｽｭ陷･�ｽ,35,1960,2),918867,438924,479943
隲｢蟶幢ｽｪ蟶ｷ諱�,隴擾ｽｭ陷･�ｽ,35,1960,2),1500687,721311,779376
鬯ｮ蛟｡陦埼ｵ�ｽ,隴擾ｽｭ陷･�ｽ,35,1960,2),854595,411162,443433
驕紋ｸ橸ｽｲ�｡騾ｵ�ｽ,隴擾ｽｭ陷･�ｽ,35,1960,2),4006679,1954636,2052043
闖ｴ蜊��ｳﾂ騾ｵ�ｽ,隴擾ｽｭ陷･�ｽ,35,1960,2),942874,448797,494077
鬮滂ｽｷ陝�螳域＝,隴擾ｽｭ陷･�ｽ,35,1960,2),1760421,860623,899798
霎ｭ鬆第た騾ｵ�ｽ,隴擾ｽｭ陷･�ｽ,35,1960,2),1856192,887038,969154
陞滂ｽｧ陋ｻ�ｽ諱�,隴擾ｽｭ陷･�ｽ,35,1960,2),1239655,590963,648692
陞ｳ�ｮ陝�螳域＝,隴擾ｽｭ陷･�ｽ,35,1960,2),1134590,552285,582305
魄厄ｽｿ陷井ｻ呻ｽｳ�ｶ騾ｵ�ｽ,隴擾ｽｭ陷･�ｽ,35,1960,2),1963104,935282,1027822
雎蝉ｹ滂ｽｸ�ｽ諱�,隴擾ｽｭ陷･�ｽ,35,1960,2),883122,422843,460279
陷茨ｽｨ陜暦ｽｽ,隴擾ｽｭ陷･�ｽ,40,1965,,99209137,48692138,50516999
陋ｹ邇ｲ�ｵ�ｷ鬩包ｿｽ,隴擾ｽｭ陷･�ｽ,40,1965,,5171800,2583159,2588641
鬮ｱ蜻茨ｽ｣�ｮ騾ｵ�ｽ,隴擾ｽｭ陷･�ｽ,40,1965,,1416591,682972,733619
陝ｯ�ｩ隰�距諱�,隴擾ｽｭ陷･�ｽ,40,1965,,1411118,679497,731621
陞ｳ�ｮ陜灘ｮ域＝,隴擾ｽｭ陷･�ｽ,40,1965,,1753126,854043,899083
驕倡距莨宣ｵ�ｽ,隴擾ｽｭ陷･�ｽ,40,1965,,1279835,614429,665406
陞ｻ�ｱ陟厄ｽ｢騾ｵ�ｽ,隴擾ｽｭ陷･�ｽ,40,1965,,1263103,605185,657918
驕紋ｸ橸ｽｳ�ｶ騾ｵ�ｽ,隴擾ｽｭ陷･�ｽ,40,1965,,1983754,954988,1028766
髣鯉ｽｨ陜灘ｮ域＝,隴擾ｽｭ陷･�ｽ,40,1965,,2056154,1007852,1048302
隴ｬ�ｽ諠�騾ｵ�ｽ,隴擾ｽｭ陷･�ｽ,40,1965,,1521656,735781,785875
驗抵ｽ､鬯･�ｬ騾ｵ�ｽ,隴擾ｽｭ陷･�ｽ,40,1965,,1605584,778916,826668
陜難ｽｼ驍��諱�,隴擾ｽｭ陷･�ｽ,40,1965,,3014983,1511947,1503036
陷奇ｿｽ逞ｩ騾ｵ�ｽ,隴擾ｽｭ陷･�ｽ,40,1965,,2701770,1343167,1358603
隴夲ｽｱ闔��ｬ鬩幢ｽｽ,隴擾ｽｭ陷･�ｽ,40,1965,,10869244,5564583,5304661
騾ｾ讒ｫ�･莠･�ｷ譎画＝,隴擾ｽｭ陷･�ｽ,40,1965,,4430743,2280926,2149817
隴�ｽｰ雋取ｺｽ諱�,隴擾ｽｭ陷･�ｽ,40,1965,,2398931,1160283,1238648
陝�ぁ�ｱ�ｱ騾ｵ�ｽ,隴擾ｽｭ陷･�ｽ,40,1965,,1025465,491662,533803
驕擾ｽｳ陝ｾ譎画＝,隴擾ｽｭ陷･�ｽ,40,1965,,980499,468518,511981
驕紋ｸ茨ｽｺ諷墓＝,隴擾ｽｭ陷･�ｽ,40,1965,,750557,359649,390908
陞ｻ�ｱ隴ｴ�ｨ騾ｵ�ｽ,隴擾ｽｭ陷･�ｽ,40,1965,,763194,367739,395455
鬮滂ｽｷ鬩･螳域＝,隴擾ｽｭ陷･�ｽ,40,1965,,1958007,937219,1020788
陝ｯ螳｣�ｽ騾ｵ�ｽ,隴擾ｽｭ陷･�ｽ,40,1965,,1700365,821444,878921
鬮ｱ蜷晢ｽｲ�｡騾ｵ�ｽ,隴擾ｽｭ陷･�ｽ,40,1965,,2912521,1428930,1483591
隲｢蟶ｷ陦埼ｵ�ｽ,隴擾ｽｭ陷･�ｽ,40,1965,,4798653,2382085,2416568
闕ｳ陋ｾ纃ｾ騾ｵ�ｽ,隴擾ｽｭ陷･�ｽ,40,1965,,1514467,727802,786665
雋顔事�ｳﾂ騾ｵ�ｽ,隴擾ｽｭ陷･�ｽ,40,1965,,853385,409502,443883
闔��ｬ鬩幢ｽｽ陟趣ｿｽ,隴擾ｽｭ陷･�ｽ,40,1965,,2102808,1028073,1074735
陞滂ｽｧ鬮ｦ�ｪ陟趣ｿｽ,隴擾ｽｭ陷･�ｽ,40,1965,,6657189,3355699,3301490
陷茨ｽｵ陟趣ｽｫ騾ｵ�ｽ,隴擾ｽｭ陷･�ｽ,40,1965,,4309944,2120749,2189195
陞るメ諞ｶ騾ｵ�ｽ,隴擾ｽｭ陷･�ｽ,40,1965,,825965,400353,425612
陷･譴ｧ�ｭ謔滂ｽｱ�ｱ騾ｵ�ｽ,隴擾ｽｭ陷･�ｽ,40,1965,,1026975,497256,529719
鬲托ｽ･陷ｿ荵滓＝,隴擾ｽｭ陷･�ｽ,40,1965,,579853,275572,304281
陝ｲ�ｶ隴ｬ�ｹ騾ｵ�ｽ,隴擾ｽｭ陷･�ｽ,40,1965,,821620,393670,427950
陝ｯ�｡陞ｻ�ｱ騾ｵ�ｽ,隴擾ｽｭ陷･�ｽ,40,1965,,1645135,781418,863717
陟趣ｿｽ�ｳ�ｶ騾ｵ�ｽ,隴擾ｽｭ陷･�ｽ,40,1965,,2281146,1107878,1173268
陞ｻ�ｱ陷ｿ�｣騾ｵ�ｽ,隴擾ｽｭ陷･�ｽ,40,1965,,1543573,740934,802639
陟包ｽｳ陝ｲ�ｶ騾ｵ�ｽ,隴擾ｽｭ陷･�ｽ,40,1965,,815115,389795,425320
鬯･蜷晢ｽｷ譎画＝,隴擾ｽｭ陷･�ｽ,40,1965,,900845,427058,473787
隲｢蟶幢ｽｪ蟶ｷ諱�,隴擾ｽｭ陷･�ｽ,40,1965,,1446384,688063,758321
鬯ｮ蛟｡陦埼ｵ�ｽ,隴擾ｽｭ陷･�ｽ,40,1965,,812714,386725,425989
驕紋ｸ橸ｽｲ�｡騾ｵ�ｽ,隴擾ｽｭ陷･�ｽ,40,1965,,3964611,1911317,2053294
闖ｴ蜊��ｳﾂ騾ｵ�ｽ,隴擾ｽｭ陷･�ｽ,40,1965,,871885,410937,460948
鬮滂ｽｷ陝�螳域＝,隴擾ｽｭ陷･�ｽ,40,1965,,1641245,788667,852578
霎ｭ鬆第た騾ｵ�ｽ,隴擾ｽｭ陷･�ｽ,40,1965,,1770736,838584,932152
陞滂ｽｧ陋ｻ�ｽ諱�,隴擾ｽｭ陷･�ｽ,40,1965,,1187480,559433,628047
陞ｳ�ｮ陝�螳域＝,隴擾ｽｭ陷･�ｽ,40,1965,,1080692,517235,563457
魄厄ｽｿ陷井ｻ呻ｽｳ�ｶ騾ｵ�ｽ,隴擾ｽｭ陷･�ｽ,40,1965,,1853541,872751,980790
雎蝉ｹ滂ｽｸ�ｽ諱�,隴擾ｽｭ陷･�ｽ,40,1965,,934176,447693,486483
陷茨ｽｨ陜暦ｽｽ,隴擾ｽｭ陷･�ｽ,45,1970,,104665171,51369177,53295994
闔��ｺ陷ｿ�｣鬮ｮ�ｽ�ｸ�ｭ陜ｨ�ｰ陋ｹ�ｺ,隴擾ｽｭ陷･�ｽ,45,1970,,55996885,27661724,28335161
闔��ｺ陷ｿ�｣鬮ｮ�ｽ�ｸ�ｭ陜ｨ�ｰ陋ｹ�ｺ闔会ｽ･陞滓じ�ｽ陜ｨ�ｰ陋ｹ�ｺ,隴擾ｽｭ陷･�ｽ,45,1970,,48668286,23707453,24960833
陋ｹ邇ｲ�ｵ�ｷ鬩包ｿｽ,隴擾ｽｭ陷･�ｽ,45,1970,,5184287,2552806,2631481
鬮ｱ蜻茨ｽ｣�ｮ騾ｵ�ｽ,隴擾ｽｭ陷･�ｽ,45,1970,,1427520,685477,742043
陝ｯ�ｩ隰�距諱�,隴擾ｽｭ陷･�ｽ,45,1970,,1371383,658458,712925
陞ｳ�ｮ陜灘ｮ域＝,隴擾ｽｭ陷･�ｽ,45,1970,,1819223,889036,930187
驕倡距莨宣ｵ�ｽ,隴擾ｽｭ陷･�ｽ,45,1970,,1241376,593232,648144
陞ｻ�ｱ陟厄ｽ｢騾ｵ�ｽ,隴擾ｽｭ陷･�ｽ,45,1970,,1225618,587515,638103
驕紋ｸ橸ｽｳ�ｶ騾ｵ�ｽ,隴擾ｽｭ陷･�ｽ,45,1970,,1946077,936202,1009875
髣鯉ｽｨ陜灘ｮ域＝,隴擾ｽｭ陷･�ｽ,45,1970,,2143551,1054003,1089548
隴ｬ�ｽ諠�騾ｵ�ｽ,隴擾ｽｭ陷･�ｽ,45,1970,,1580021,769524,810497
驗抵ｽ､鬯･�ｬ騾ｵ�ｽ,隴擾ｽｭ陷･�ｽ,45,1970,,1658909,808270,850639
陜難ｽｼ驍��諱�,隴擾ｽｭ陷･�ｽ,45,1970,,3866472,1951219,1915253
陷奇ｿｽ逞ｩ騾ｵ�ｽ,隴擾ｽｭ陷･�ｽ,45,1970,,3366624,1694854,1671770
隴夲ｽｱ闔��ｬ鬩幢ｽｽ,隴擾ｽｭ陷･�ｽ,45,1970,,11408071,5801009,5607062
騾ｾ讒ｫ�･莠･�ｷ譎画＝,隴擾ｽｭ陷･�ｽ,45,1970,,5472247,2822212,2650035
隴�ｽｰ雋取ｺｽ諱�,隴擾ｽｭ陷･�ｽ,45,1970,,2360982,1140148,1220834
陝�ぁ�ｱ�ｱ騾ｵ�ｽ,隴擾ｽｭ陷･�ｽ,45,1970,,1029695,492492,537203
驕擾ｽｳ陝ｾ譎画＝,隴擾ｽｭ陷･�ｽ,45,1970,,1002420,480380,522040
驕紋ｸ茨ｽｺ諷墓＝,隴擾ｽｭ陷･�ｽ,45,1970,,744230,356639,387591
陞ｻ�ｱ隴ｴ�ｨ騾ｵ�ｽ,隴擾ｽｭ陷･�ｽ,45,1970,,762029,366925,395104
鬮滂ｽｷ鬩･螳域＝,隴擾ｽｭ陷･�ｽ,45,1970,,1956917,936354,1020563
陝ｯ螳｣�ｽ騾ｵ�ｽ,隴擾ｽｭ陷･�ｽ,45,1970,,1758954,848786,910168
鬮ｱ蜷晢ｽｲ�｡騾ｵ�ｽ,隴擾ｽｭ陷･�ｽ,45,1970,,3089895,1516642,1573253
隲｢蟶ｷ陦埼ｵ�ｽ,隴擾ｽｭ陷･�ｽ,45,1970,,5386163,2694991,2691172
闕ｳ陋ｾ纃ｾ騾ｵ�ｽ,隴擾ｽｭ陷･�ｽ,45,1970,,1543083,742461,800622
雋顔事�ｳﾂ騾ｵ�ｽ,隴擾ｽｭ陷･�ｽ,45,1970,,889768,429885,459883
闔��ｬ鬩幢ｽｽ陟趣ｿｽ,隴擾ｽｭ陷･�ｽ,45,1970,,2250087,1102011,1148076
陞滂ｽｧ鬮ｦ�ｪ陟趣ｿｽ,隴擾ｽｭ陷･�ｽ,45,1970,,7620480,3823622,3796858
陷茨ｽｵ陟趣ｽｫ騾ｵ�ｽ,隴擾ｽｭ陷･�ｽ,45,1970,,4667928,2299961,2367967
陞るメ諞ｶ騾ｵ�ｽ,隴擾ｽｭ陷･�ｽ,45,1970,,930160,450668,479492
陷･譴ｧ�ｭ謔滂ｽｱ�ｱ騾ｵ�ｽ,隴擾ｽｭ陷･�ｽ,45,1970,,1042736,503202,539534
鬲托ｽ･陷ｿ荵滓＝,隴擾ｽｭ陷･�ｽ,45,1970,,568777,269497,299280
陝ｲ�ｶ隴ｬ�ｹ騾ｵ�ｽ,隴擾ｽｭ陷･�ｽ,45,1970,,773575,367658,405917
陝ｯ�｡陞ｻ�ｱ騾ｵ�ｽ,隴擾ｽｭ陷･�ｽ,45,1970,,1707026,819359,887667
陟趣ｿｽ�ｳ�ｶ騾ｵ�ｽ,隴擾ｽｭ陷･�ｽ,45,1970,,2436135,1188270,1247865
陞ｻ�ｱ陷ｿ�｣騾ｵ�ｽ,隴擾ｽｭ陷･�ｽ,45,1970,,1511448,719147,792301
陟包ｽｳ陝ｲ�ｶ騾ｵ�ｽ,隴擾ｽｭ陷･�ｽ,45,1970,,791111,376729,414382
鬯･蜷晢ｽｷ譎画＝,隴擾ｽｭ陷･�ｽ,45,1970,,907897,430773,477124
隲｢蟶幢ｽｪ蟶ｷ諱�,隴擾ｽｭ陷･�ｽ,45,1970,,1418124,670980,747144
鬯ｮ蛟｡陦埼ｵ�ｽ,隴擾ｽｭ陷･�ｽ,45,1970,,786882,372014,414868
驕紋ｸ橸ｽｲ�｡騾ｵ�ｽ,隴擾ｽｭ陷･�ｽ,45,1970,,4027416,1932033,2095383
闖ｴ蜊��ｳﾂ騾ｵ�ｽ,隴擾ｽｭ陷･�ｽ,45,1970,,838468,393631,444837
鬮滂ｽｷ陝�螳域＝,隴擾ｽｭ陷･�ｽ,45,1970,,1570245,747971,822274
霎ｭ鬆第た騾ｵ�ｽ,隴擾ｽｭ陷･�ｽ,45,1970,,1700229,798152,902077
陞滂ｽｧ陋ｻ�ｽ諱�,隴擾ｽｭ陷･�ｽ,45,1970,,1155566,540541,615025
陞ｳ�ｮ陝�螳域＝,隴擾ｽｭ陷･�ｽ,45,1970,,1051105,498065,553040
魄厄ｽｿ陷井ｻ呻ｽｳ�ｶ騾ｵ�ｽ,隴擾ｽｭ陷･�ｽ,45,1970,,1729150,803980,925170
雎蝉ｹ滂ｽｸ�ｽ諱�,隴擾ｽｭ陷･�ｽ,45,1970,,945111,451393,493718
陷茨ｽｨ陜暦ｽｽ,隴擾ｽｭ陷･�ｽ,50,1975,,111939643,55090673,56848970
闔��ｺ陷ｿ�｣鬮ｮ�ｽ�ｸ�ｭ陜ｨ�ｰ陋ｹ�ｺ,隴擾ｽｭ陷･�ｽ,50,1975,,63822648,31574677,32247971
闔��ｺ陷ｿ�｣鬮ｮ�ｽ�ｸ�ｭ陜ｨ�ｰ陋ｹ�ｺ闔会ｽ･陞滓じ�ｽ陜ｨ�ｰ陋ｹ�ｺ,隴擾ｽｭ陷･�ｽ,50,1975,,48116995,23515996,24600999
陋ｹ邇ｲ�ｵ�ｷ鬩包ｿｽ,隴擾ｽｭ陷･�ｽ,50,1975,,5338206,2621285,2716921
鬮ｱ蜻茨ｽ｣�ｮ騾ｵ�ｽ,隴擾ｽｭ陷･�ｽ,50,1975,,1468646,707232,761414
陝ｯ�ｩ隰�距諱�,隴擾ｽｭ陷･�ｽ,50,1975,,1385563,668193,717370
陞ｳ�ｮ陜灘ｮ域＝,隴擾ｽｭ陷･�ｽ,50,1975,,1955267,960245,995022
驕倡距莨宣ｵ�ｽ,隴擾ｽｭ陷･�ｽ,50,1975,,1232481,590492,641989
陞ｻ�ｱ陟厄ｽ｢騾ｵ�ｽ,隴擾ｽｭ陷･�ｽ,50,1975,,1220302,586918,633384
驕紋ｸ橸ｽｳ�ｶ騾ｵ�ｽ,隴擾ｽｭ陷･�ｽ,50,1975,,1970616,953449,1017167
髣鯉ｽｨ陜灘ｮ域＝,隴擾ｽｭ陷･�ｽ,50,1975,,2342198,1159707,1182491
隴ｬ�ｽ諠�騾ｵ�ｽ,隴擾ｽｭ陷･�ｽ,50,1975,,1698003,834794,863209
驗抵ｽ､鬯･�ｬ騾ｵ�ｽ,隴擾ｽｭ陷･�ｽ,50,1975,,1756480,859364,897116
陜難ｽｼ驍��諱�,隴擾ｽｭ陷･�ｽ,50,1975,,4821340,2437128,2384212
陷奇ｿｽ逞ｩ騾ｵ�ｽ,隴擾ｽｭ陷･�ｽ,50,1975,,4149147,2095295,2053852
隴夲ｽｱ闔��ｬ鬩幢ｽｽ,隴擾ｽｭ陷･�ｽ,50,1975,,11673554,5913373,5760181
騾ｾ讒ｫ�･莠･�ｷ譎画＝,隴擾ｽｭ陷･�ｽ,50,1975,,6397748,3287118,3110630
隴�ｽｰ雋取ｺｽ諱�,隴擾ｽｭ陷･�ｽ,50,1975,,2391938,1160869,1231069
陝�ぁ�ｱ�ｱ騾ｵ�ｽ,隴擾ｽｭ陷･�ｽ,50,1975,,1070791,514991,555800
驕擾ｽｳ陝ｾ譎画＝,隴擾ｽｭ陷･�ｽ,50,1975,,1069872,518594,551278
驕紋ｸ茨ｽｺ諷墓＝,隴擾ｽｭ陷･�ｽ,50,1975,,773599,373416,400183
陞ｻ�ｱ隴ｴ�ｨ騾ｵ�ｽ,隴擾ｽｭ陷･�ｽ,50,1975,,783050,379283,403767
鬮滂ｽｷ鬩･螳域＝,隴擾ｽｭ陷･�ｽ,50,1975,,2017564,972471,1045093
陝ｯ螳｣�ｽ騾ｵ�ｽ,隴擾ｽｭ陷･�ｽ,50,1975,,1867978,907382,960596
鬮ｱ蜷晢ｽｲ�｡騾ｵ�ｽ,隴擾ｽｭ陷･�ｽ,50,1975,,3308799,1627797,1681002
隲｢蟶ｷ陦埼ｵ�ｽ,隴擾ｽｭ陷･�ｽ,50,1975,,5923569,2966388,2957181
闕ｳ陋ｾ纃ｾ騾ｵ�ｽ,隴擾ｽｭ陷･�ｽ,50,1975,,1626002,787280,838722
雋顔事�ｳﾂ騾ｵ�ｽ,隴擾ｽｭ陷･�ｽ,50,1975,,985621,481733,503888
闔��ｬ鬩幢ｽｽ陟趣ｿｽ,隴擾ｽｭ陷･�ｽ,50,1975,,2424856,1190854,1234002
陞滂ｽｧ鬮ｦ�ｪ陟趣ｿｽ,隴擾ｽｭ陷･�ｽ,50,1975,,8278925,4132495,4146430
陷茨ｽｵ陟趣ｽｫ騾ｵ�ｽ,隴擾ｽｭ陷･�ｽ,50,1975,,4992140,2453277,2538863
陞るメ諞ｶ騾ｵ�ｽ,隴擾ｽｭ陷･�ｽ,50,1975,,1077491,523633,553858
陷･譴ｧ�ｭ謔滂ｽｱ�ｱ騾ｵ�ｽ,隴擾ｽｭ陷･�ｽ,50,1975,,1072118,517868,554250
鬲托ｽ･陷ｿ荵滓＝,隴擾ｽｭ陷･�ｽ,50,1975,,581311,277151,304160
陝ｲ�ｶ隴ｬ�ｹ騾ｵ�ｽ,隴擾ｽｭ陷･�ｽ,50,1975,,768886,367060,401826
陝ｯ�｡陞ｻ�ｱ騾ｵ�ｽ,隴擾ｽｭ陷･�ｽ,50,1975,,1814305,878132,936173
陟趣ｿｽ�ｳ�ｶ騾ｵ�ｽ,隴擾ｽｭ陷･�ｽ,50,1975,,2646324,1296677,1349647
陞ｻ�ｱ陷ｿ�｣騾ｵ�ｽ,隴擾ｽｭ陷･�ｽ,50,1975,,1555218,743833,811385
陟包ｽｳ陝ｲ�ｶ騾ｵ�ｽ,隴擾ｽｭ陷･�ｽ,50,1975,,805166,384812,420354
鬯･蜷晢ｽｷ譎画＝,隴擾ｽｭ陷･�ｽ,50,1975,,961292,461370,499922
隲｢蟶幢ｽｪ蟶ｷ諱�,隴擾ｽｭ陷･�ｽ,50,1975,,1465215,697794,767421
鬯ｮ蛟｡陦埼ｵ�ｽ,隴擾ｽｭ陷･�ｽ,50,1975,,808397,383538,424859
驕紋ｸ橸ｽｲ�｡騾ｵ�ｽ,隴擾ｽｭ陷･�ｽ,50,1975,,4292963,2070190,2222773
闖ｴ蜊��ｳﾂ騾ｵ�ｽ,隴擾ｽｭ陷･�ｽ,50,1975,,837674,394661,443013
鬮滂ｽｷ陝�螳域＝,隴擾ｽｭ陷･�ｽ,50,1975,,1571912,750418,821494
霎ｭ鬆第た騾ｵ�ｽ,隴擾ｽｭ陷･�ｽ,50,1975,,1715273,809998,905275
陞滂ｽｧ陋ｻ�ｽ諱�,隴擾ｽｭ陷･�ｽ,50,1975,,1190314,561760,628554
陞ｳ�ｮ陝�螳域＝,隴擾ｽｭ陷･�ｽ,50,1975,,1085055,515236,569819
魄厄ｽｿ陷井ｻ呻ｽｳ�ｶ騾ｵ�ｽ,隴擾ｽｭ陷･�ｽ,50,1975,,1723902,804365,919537
雎蝉ｹ滂ｽｸ�ｽ諱�,隴擾ｽｭ陷･�ｽ,50,1975,,1042572,510754,531818
陷茨ｽｨ陜暦ｽｽ,隴擾ｽｭ陷･�ｽ,55,1980,,117060396,57593769,59466627
闔��ｺ陷ｿ�｣鬮ｮ�ｽ�ｸ�ｭ陜ｨ�ｰ陋ｹ�ｺ,隴擾ｽｭ陷･�ｽ,55,1980,,69934854,34530429,35404425
闔��ｺ陷ｿ�｣鬮ｮ�ｽ�ｸ�ｭ陜ｨ�ｰ陋ｹ�ｺ闔会ｽ･陞滓じ�ｽ陜ｨ�ｰ陋ｹ�ｺ,隴擾ｽｭ陷･�ｽ,55,1980,,47125542,23063340,24062202
陋ｹ邇ｲ�ｵ�ｷ鬩包ｿｽ,隴擾ｽｭ陷･�ｽ,55,1980,,5575989,2737089,2838900
鬮ｱ蜻茨ｽ｣�ｮ騾ｵ�ｽ,隴擾ｽｭ陷･�ｽ,55,1980,,1523907,735444,788463
陝ｯ�ｩ隰�距諱�,隴擾ｽｭ陷･�ｽ,55,1980,,1421927,688460,733467
陞ｳ�ｮ陜灘ｮ域＝,隴擾ｽｭ陷･�ｽ,55,1980,,2082320,1025903,1056417
驕倡距莨宣ｵ�ｽ,隴擾ｽｭ陷･�ｽ,55,1980,,1256745,603403,653342
陞ｻ�ｱ陟厄ｽ｢騾ｵ�ｽ,隴擾ｽｭ陷･�ｽ,55,1980,,1251917,605407,646510
驕紋ｸ橸ｽｳ�ｶ騾ｵ�ｽ,隴擾ｽｭ陷･�ｽ,55,1980,,2035272,990575,1044697
髣鯉ｽｨ陜灘ｮ域＝,隴擾ｽｭ陷･�ｽ,55,1980,,2558007,1272533,1285474
隴ｬ�ｽ諠�騾ｵ�ｽ,隴擾ｽｭ陷･�ｽ,55,1980,,1792201,885573,906628
驗抵ｽ､鬯･�ｬ騾ｵ�ｽ,隴擾ｽｭ陷･�ｽ,55,1980,,1848562,908871,939691
陜難ｽｼ驍��諱�,隴擾ｽｭ陷･�ｽ,55,1980,,5420480,2739175,2681305
陷奇ｿｽ逞ｩ騾ｵ�ｽ,隴擾ｽｭ陷･�ｽ,55,1980,,4735424,2383157,2352267
隴夲ｽｱ闔��ｬ鬩幢ｽｽ,隴擾ｽｭ陷･�ｽ,55,1980,,11618281,5856280,5762001
騾ｾ讒ｫ�･莠･�ｷ譎画＝,隴擾ｽｭ陷･�ｽ,55,1980,,6924348,3536021,3388327
隴�ｽｰ雋取ｺｽ諱�,隴擾ｽｭ陷･�ｽ,55,1980,,2451357,1193653,1257704
陝�ぁ�ｱ�ｱ騾ｵ�ｽ,隴擾ｽｭ陷･�ｽ,55,1980,,1103459,532686,570773
驕擾ｽｳ陝ｾ譎画＝,隴擾ｽｭ陷･�ｽ,55,1980,,1119304,542782,576522
驕紋ｸ茨ｽｺ諷墓＝,隴擾ｽｭ陷･�ｽ,55,1980,,794354,384269,410085
陞ｻ�ｱ隴ｴ�ｨ騾ｵ�ｽ,隴擾ｽｭ陷･�ｽ,55,1980,,804256,391649,412607
鬮滂ｽｷ鬩･螳域＝,隴擾ｽｭ陷･�ｽ,55,1980,,2083934,1008885,1075049
陝ｯ螳｣�ｽ騾ｵ�ｽ,隴擾ｽｭ陷･�ｽ,55,1980,,1960107,954018,1006089
鬮ｱ蜷晢ｽｲ�｡騾ｵ�ｽ,隴擾ｽｭ陷･�ｽ,55,1980,,3446804,1695778,1751026
隲｢蟶ｷ陦埼ｵ�ｽ,隴擾ｽｭ陷･�ｽ,55,1980,,6221638,3112306,3109332
闕ｳ陋ｾ纃ｾ騾ｵ�ｽ,隴擾ｽｭ陷･�ｽ,55,1980,,1686936,817578,869358
雋顔事�ｳﾂ騾ｵ�ｽ,隴擾ｽｭ陷･�ｽ,55,1980,,1079898,529208,550690
闔��ｬ鬩幢ｽｽ陟趣ｿｽ,隴擾ｽｭ陷･�ｽ,55,1980,,2527330,1238365,1288965
陞滂ｽｧ鬮ｦ�ｪ陟趣ｿｽ,隴擾ｽｭ陷･�ｽ,55,1980,,8473446,4203838,4269608
陷茨ｽｵ陟趣ｽｫ騾ｵ�ｽ,隴擾ｽｭ陷･�ｽ,55,1980,,5144892,2512358,2632534
陞るメ諞ｶ騾ｵ�ｽ,隴擾ｽｭ陷･�ｽ,55,1980,,1209365,587067,622298
陷･譴ｧ�ｭ謔滂ｽｱ�ｱ騾ｵ�ｽ,隴擾ｽｭ陷･�ｽ,55,1980,,1087012,523467,563545
鬲托ｽ･陷ｿ荵滓＝,隴擾ｽｭ陷･�ｽ,55,1980,,604221,289946,314275
陝ｲ�ｶ隴ｬ�ｹ騾ｵ�ｽ,隴擾ｽｭ陷･�ｽ,55,1980,,784795,377499,407296
陝ｯ�｡陞ｻ�ｱ騾ｵ�ｽ,隴擾ｽｭ陷･�ｽ,55,1980,,1871023,905477,965546
陟趣ｿｽ�ｳ�ｶ騾ｵ�ｽ,隴擾ｽｭ陷･�ｽ,55,1980,,2739161,1336806,1402355
陞ｻ�ｱ陷ｿ�｣騾ｵ�ｽ,隴擾ｽｭ陷･�ｽ,55,1980,,1587079,759255,827824
陟包ｽｳ陝ｲ�ｶ騾ｵ�ｽ,隴擾ｽｭ陷･�ｽ,55,1980,,825261,395994,429267
鬯･蜷晢ｽｷ譎画＝,隴擾ｽｭ陷･�ｽ,55,1980,,999864,481104,518760
隲｢蟶幢ｽｪ蟶ｷ諱�,隴擾ｽｭ陷･�ｽ,55,1980,,1506637,718517,788120
鬯ｮ蛟｡陦埼ｵ�ｽ,隴擾ｽｭ陷･�ｽ,55,1980,,831275,396418,434857
驕紋ｸ橸ｽｲ�｡騾ｵ�ｽ,隴擾ｽｭ陷･�ｽ,55,1980,,4553461,2200450,2353011
闖ｴ蜊��ｳﾂ騾ｵ�ｽ,隴擾ｽｭ陷･�ｽ,55,1980,,865574,410912,454662
鬮滂ｽｷ陝�螳域＝,隴擾ｽｭ陷･�ｽ,55,1980,,1590564,758374,832190
霎ｭ鬆第た騾ｵ�ｽ,隴擾ｽｭ陷･�ｽ,55,1980,,1790327,850831,939496
陞滂ｽｧ陋ｻ�ｽ諱�,隴擾ｽｭ陷･�ｽ,55,1980,,1228913,583097,645816
陞ｳ�ｮ陝�螳域＝,隴擾ｽｭ陷･�ｽ,55,1980,,1151587,550207,601380
魄厄ｽｿ陷井ｻ呻ｽｳ�ｶ騾ｵ�ｽ,隴擾ｽｭ陷･�ｽ,55,1980,,1784623,839392,945231
雎蝉ｹ滂ｽｸ�ｽ諱�,隴擾ｽｭ陷･�ｽ,55,1980,,1106559,543692,562867
陷茨ｽｨ陜暦ｽｽ,隴擾ｽｭ陷･�ｽ,60,1985,,121048923,59497316,61551607
闔��ｺ陷ｿ�｣鬮ｮ�ｽ�ｸ�ｭ陜ｨ�ｰ陋ｹ�ｺ,隴擾ｽｭ陷･�ｽ,60,1985,,73344121,36173221,37170900
闔��ｺ陷ｿ�｣鬮ｮ�ｽ�ｸ�ｭ陜ｨ�ｰ陋ｹ�ｺ闔会ｽ･陞滓じ�ｽ陜ｨ�ｰ陋ｹ�ｺ,隴擾ｽｭ陷･�ｽ,60,1985,,47704802,23324095,24380707
陋ｹ邇ｲ�ｵ�ｷ鬩包ｿｽ,隴擾ｽｭ陷･�ｽ,60,1985,,5679439,2766296,2913143
鬮ｱ蜻茨ｽ｣�ｮ騾ｵ�ｽ,隴擾ｽｭ陷･�ｽ,60,1985,,1524448,731439,793009
陝ｯ�ｩ隰�距諱�,隴擾ｽｭ陷･�ｽ,60,1985,,1433611,691740,741871
陞ｳ�ｮ陜灘ｮ域＝,隴擾ｽｭ陷･�ｽ,60,1985,,2176295,1071741,1104554
驕倡距莨宣ｵ�ｽ,隴擾ｽｭ陷･�ｽ,60,1985,,1254032,599591,654441
陞ｻ�ｱ陟厄ｽ｢騾ｵ�ｽ,隴擾ｽｭ陷･�ｽ,60,1985,,1261662,609417,652245
驕紋ｸ橸ｽｳ�ｶ騾ｵ�ｽ,隴擾ｽｭ陷･�ｽ,60,1985,,2080304,1012456,1067848
髣鯉ｽｨ陜灘ｮ域＝,隴擾ｽｭ陷･�ｽ,60,1985,,2725005,1357963,1367042
隴ｬ�ｽ諠�騾ｵ�ｽ,隴擾ｽｭ陷･�ｽ,60,1985,,1866066,924221,941845
驗抵ｽ､鬯･�ｬ騾ｵ�ｽ,隴擾ｽｭ陷･�ｽ,60,1985,,1921259,947013,974246
陜難ｽｼ驍��諱�,隴擾ｽｭ陷･�ｽ,60,1985,,5863678,2961591,2902087
陷奇ｿｽ逞ｩ騾ｵ�ｽ,隴擾ｽｭ陷･�ｽ,60,1985,,5148163,2588365,2559798
隴夲ｽｱ闔��ｬ鬩幢ｽｽ,隴擾ｽｭ陷･�ｽ,60,1985,,11829363,5955029,5874334
騾ｾ讒ｫ�･莠･�ｷ譎画＝,隴擾ｽｭ陷･�ｽ,60,1985,,7431974,3804081,3627893
隴�ｽｰ雋取ｺｽ諱�,隴擾ｽｭ陷･�ｽ,60,1985,,2478470,1205071,1273399
陝�ぁ�ｱ�ｱ騾ｵ�ｽ,隴擾ｽｭ陷･�ｽ,60,1985,,1118369,538955,579414
驕擾ｽｳ陝ｾ譎画＝,隴擾ｽｭ陷･�ｽ,60,1985,,1152325,557664,594661
驕紋ｸ茨ｽｺ諷墓＝,隴擾ｽｭ陷･�ｽ,60,1985,,817633,397115,420518
陞ｻ�ｱ隴ｴ�ｨ騾ｵ�ｽ,隴擾ｽｭ陷･�ｽ,60,1985,,832832,407910,424922
鬮滂ｽｷ鬩･螳域＝,隴擾ｽｭ陷･�ｽ,60,1985,,2136927,1038070,1098857
陝ｯ螳｣�ｽ騾ｵ�ｽ,隴擾ｽｭ陷･�ｽ,60,1985,,2028536,986919,1041617
鬮ｱ蜷晢ｽｲ�｡騾ｵ�ｽ,隴擾ｽｭ陷･�ｽ,60,1985,,3574692,1759455,1815237
隲｢蟶ｷ陦埼ｵ�ｽ,隴擾ｽｭ陷･�ｽ,60,1985,,6455172,3228724,3226448
闕ｳ陋ｾ纃ｾ騾ｵ�ｽ,隴擾ｽｭ陷･�ｽ,60,1985,,1747311,847420,899891
雋顔事�ｳﾂ騾ｵ�ｽ,隴擾ｽｭ陷･�ｽ,60,1985,,1155844,568735,587109
闔��ｬ鬩幢ｽｽ陟趣ｿｽ,隴擾ｽｭ陷･�ｽ,60,1985,,2586574,1264035,1322539
陞滂ｽｧ鬮ｦ�ｪ陟趣ｿｽ,隴擾ｽｭ陷･�ｽ,60,1985,,8668095,4286445,4381650
陷茨ｽｵ陟趣ｽｫ騾ｵ�ｽ,隴擾ｽｭ陷･�ｽ,60,1985,,5278050,2567814,2710236
陞るメ諞ｶ騾ｵ�ｽ,隴擾ｽｭ陷･�ｽ,60,1985,,1304866,632955,671911
陷･譴ｧ�ｭ謔滂ｽｱ�ｱ騾ｵ�ｽ,隴擾ｽｭ陷･�ｽ,60,1985,,1087206,520172,567034
鬲托ｽ･陷ｿ荵滓＝,隴擾ｽｭ陷･�ｽ,60,1985,,616024,295511,320513
陝ｲ�ｶ隴ｬ�ｹ騾ｵ�ｽ,隴擾ｽｭ陷･�ｽ,60,1985,,794629,382893,411736
陝ｯ�｡陞ｻ�ｱ騾ｵ�ｽ,隴擾ｽｭ陷･�ｽ,60,1985,,1916906,926238,990668
陟趣ｿｽ�ｳ�ｶ騾ｵ�ｽ,隴擾ｽｭ陷･�ｽ,60,1985,,2819200,1373853,1445347
陞ｻ�ｱ陷ｿ�｣騾ｵ�ｽ,隴擾ｽｭ陷･�ｽ,60,1985,,1601627,763803,837824
陟包ｽｳ陝ｲ�ｶ騾ｵ�ｽ,隴擾ｽｭ陷･�ｽ,60,1985,,834889,399689,435200
鬯･蜷晢ｽｷ譎画＝,隴擾ｽｭ陷･�ｽ,60,1985,,1022569,492696,529873
隲｢蟶幢ｽｪ蟶ｷ諱�,隴擾ｽｭ陷･�ｽ,60,1985,,1529983,728506,801477
鬯ｮ蛟｡陦埼ｵ�ｽ,隴擾ｽｭ陷･�ｽ,60,1985,,839784,398408,441376
驕紋ｸ橸ｽｲ�｡騾ｵ�ｽ,隴擾ｽｭ陷･�ｽ,60,1985,,4719259,2270496,2448763
闖ｴ蜊��ｳﾂ騾ｵ�ｽ,隴擾ｽｭ陷･�ｽ,60,1985,,880013,417308,462705
鬮滂ｽｷ陝�螳域＝,隴擾ｽｭ陷･�ｽ,60,1985,,1593968,757617,836351
霎ｭ鬆第た騾ｵ�ｽ,隴擾ｽｭ陷･�ｽ,60,1985,,1837747,872932,964815
陞滂ｽｧ陋ｻ�ｽ諱�,隴擾ｽｭ陷･�ｽ,60,1985,,1250214,593014,657200
陞ｳ�ｮ陝�螳域＝,隴擾ｽｭ陷･�ｽ,60,1985,,1175543,558355,617188
魄厄ｽｿ陷井ｻ呻ｽｳ�ｶ騾ｵ�ｽ,隴擾ｽｭ陷･�ｽ,60,1985,,1819270,856493,962777
雎蝉ｹ滂ｽｸ�ｽ諱�,隴擾ｽｭ陷･�ｽ,60,1985,,1179097,581102,597995
陷茨ｽｨ陜暦ｽｽ,陝ｷ�ｳ隰鯉ｿｽ,2,1990,,123611167,60696724,62914443
闔��ｺ陷ｿ�｣鬮ｮ�ｽ�ｸ�ｭ陜ｨ�ｰ陋ｹ�ｺ,陝ｷ�ｳ隰鯉ｿｽ,2,1990,,78152452,38564229,39588223
闔��ｺ陷ｿ�｣鬮ｮ�ｽ�ｸ�ｭ陜ｨ�ｰ陋ｹ�ｺ闔会ｽ･陞滓じ�ｽ陜ｨ�ｰ陋ｹ�ｺ,陝ｷ�ｳ隰鯉ｿｽ,2,1990,,45458715,22132495,23326220
陋ｹ邇ｲ�ｵ�ｷ鬩包ｿｽ,陝ｷ�ｳ隰鯉ｿｽ,2,1990,,5643647,2722988,2920659
鬮ｱ蜻茨ｽ｣�ｮ騾ｵ�ｽ,陝ｷ�ｳ隰鯉ｿｽ,2,1990,,1482873,704758,778115
陝ｯ�ｩ隰�距諱�,陝ｷ�ｳ隰鯉ｿｽ,2,1990,,1416928,680197,736731
陞ｳ�ｮ陜灘ｮ域＝,陝ｷ�ｳ隰鯉ｿｽ,2,1990,,2248558,1105103,1143455
驕倡距莨宣ｵ�ｽ,陝ｷ�ｳ隰鯉ｿｽ,2,1990,,1227478,584678,642800
陞ｻ�ｱ陟厄ｽ｢騾ｵ�ｽ,陝ｷ�ｳ隰鯉ｿｽ,2,1990,,1258390,607041,651349
驕紋ｸ橸ｽｳ�ｶ騾ｵ�ｽ,陝ｷ�ｳ隰鯉ｿｽ,2,1990,,2104058,1024354,1079704
髣鯉ｽｨ陜灘ｮ域＝,陝ｷ�ｳ隰鯉ｿｽ,2,1990,,2845382,1419117,1426265
隴ｬ�ｽ諠�騾ｵ�ｽ,陝ｷ�ｳ隰鯉ｿｽ,2,1990,,1935168,962571,972597
驗抵ｽ､鬯･�ｬ騾ｵ�ｽ,陝ｷ�ｳ隰鯉ｿｽ,2,1990,,1966265,971704,994561
陜難ｽｼ驍��諱�,陝ｷ�ｳ隰鯉ｿｽ,2,1990,,6405319,3245868,3159451
陷奇ｿｽ逞ｩ騾ｵ�ｽ,陝ｷ�ｳ隰鯉ｿｽ,2,1990,,5555429,2802774,2752655
隴夲ｽｱ闔��ｬ鬩幢ｽｽ,陝ｷ�ｳ隰鯉ｿｽ,2,1990,,11855563,5969773,5885790
騾ｾ讒ｫ�･莠･�ｷ譎画＝,陝ｷ�ｳ隰鯉ｿｽ,2,1990,,7980391,4098147,3882244
隴�ｽｰ雋取ｺｽ諱�,陝ｷ�ｳ隰鯉ｿｽ,2,1990,,2474583,1200376,1274207
陝�ぁ�ｱ�ｱ騾ｵ�ｽ,陝ｷ�ｳ隰鯉ｿｽ,2,1990,,1120161,538640,581521
驕擾ｽｳ陝ｾ譎画＝,陝ｷ�ｳ隰鯉ｿｽ,2,1990,,1164628,562684,601944
驕紋ｸ茨ｽｺ諷墓＝,陝ｷ�ｳ隰鯉ｿｽ,2,1990,,823585,400391,423194
陞ｻ�ｱ隴ｴ�ｨ騾ｵ�ｽ,陝ｷ�ｳ隰鯉ｿｽ,2,1990,,852966,418701,434265
鬮滂ｽｷ鬩･螳域＝,陝ｷ�ｳ隰鯉ｿｽ,2,1990,,2156627,1048109,1108518
陝ｯ螳｣�ｽ騾ｵ�ｽ,陝ｷ�ｳ隰鯉ｿｽ,2,1990,,2066569,1003933,1062636
鬮ｱ蜷晢ｽｲ�｡騾ｵ�ｽ,陝ｷ�ｳ隰鯉ｿｽ,2,1990,,3670840,1808951,1861889
隲｢蟶ｷ陦埼ｵ�ｽ,陝ｷ�ｳ隰鯉ｿｽ,2,1990,,6690603,3354827,3335776
闕ｳ陋ｾ纃ｾ騾ｵ�ｽ,陝ｷ�ｳ隰鯉ｿｽ,2,1990,,1792514,869515,922999
雋顔事�ｳﾂ騾ｵ�ｽ,陝ｷ�ｳ隰鯉ｿｽ,2,1990,,1222411,601082,621329
闔��ｬ鬩幢ｽｽ陟趣ｿｽ,陝ｷ�ｳ隰鯉ｿｽ,2,1990,,2602460,1267620,1334840
陞滂ｽｧ鬮ｦ�ｪ陟趣ｿｽ,陝ｷ�ｳ隰鯉ｿｽ,2,1990,,8734516,4308184,4426332
陷茨ｽｵ陟趣ｽｫ騾ｵ�ｽ,陝ｷ�ｳ隰鯉ｿｽ,2,1990,,5405040,2619692,2785348
陞るメ諞ｶ騾ｵ�ｽ,陝ｷ�ｳ隰鯉ｿｽ,2,1990,,1375481,663591,711890
陷･譴ｧ�ｭ謔滂ｽｱ�ｱ騾ｵ�ｽ,陝ｷ�ｳ隰鯉ｿｽ,2,1990,,1074325,510777,563548
鬲托ｽ･陷ｿ荵滓＝,陝ｷ�ｳ隰鯉ｿｽ,2,1990,,615722,294899,320823
陝ｲ�ｶ隴ｬ�ｹ騾ｵ�ｽ,陝ｷ�ｳ隰鯉ｿｽ,2,1990,,781021,373618,407403
陝ｯ�｡陞ｻ�ｱ騾ｵ�ｽ,陝ｷ�ｳ隰鯉ｿｽ,2,1990,,1925877,926721,999156
陟趣ｿｽ�ｳ�ｶ騾ｵ�ｽ,陝ｷ�ｳ隰鯉ｿｽ,2,1990,,2849847,1385297,1464550
陞ｻ�ｱ陷ｿ�｣騾ｵ�ｽ,陝ｷ�ｳ隰鯉ｿｽ,2,1990,,1572616,744844,827772
陟包ｽｳ陝ｲ�ｶ騾ｵ�ｽ,陝ｷ�ｳ隰鯉ｿｽ,2,1990,,831598,395906,435692
鬯･蜷晢ｽｷ譎画＝,陝ｷ�ｳ隰鯉ｿｽ,2,1990,,1023412,491621,531791
隲｢蟶幢ｽｪ蟶ｷ諱�,陝ｷ�ｳ隰鯉ｿｽ,2,1990,,1515025,716940,798085
鬯ｮ蛟｡陦埼ｵ�ｽ,陝ｷ�ｳ隰鯉ｿｽ,2,1990,,825034,389063,435971
驕紋ｸ橸ｽｲ�｡騾ｵ�ｽ,陝ｷ�ｳ隰鯉ｿｽ,2,1990,,4811050,2303487,2507563
闖ｴ蜊��ｳﾂ騾ｵ�ｽ,陝ｷ�ｳ隰鯉ｿｽ,2,1990,,877851,414673,463178
鬮滂ｽｷ陝�螳域＝,陝ｷ�ｳ隰鯉ｿｽ,2,1990,,1562959,736729,826230
霎ｭ鬆第た騾ｵ�ｽ,陝ｷ�ｳ隰鯉ｿｽ,2,1990,,1840326,869441,970885
陞滂ｽｧ陋ｻ�ｽ諱�,陝ｷ�ｳ隰鯉ｿｽ,2,1990,,1236942,584672,652270
陞ｳ�ｮ陝�螳域＝,陝ｷ�ｳ隰鯉ｿｽ,2,1990,,1168907,551524,617383
魄厄ｽｿ陷井ｻ呻ｽｳ�ｶ騾ｵ�ｽ,陝ｷ�ｳ隰鯉ｿｽ,2,1990,,1797824,842474,955350
雎蝉ｹ滂ｽｸ�ｽ諱�,陝ｷ�ｳ隰鯉ｿｽ,2,1990,,1222398,598669,623729
陷茨ｽｨ陜暦ｽｽ,陝ｷ�ｳ隰鯉ｿｽ,7,1995,,125570246,61574398,63995848
闔��ｺ陷ｿ�｣鬮ｮ�ｽ�ｸ�ｭ陜ｨ�ｰ陋ｹ�ｺ,陝ｷ�ｳ隰鯉ｿｽ,7,1995,,81254670,40027402,41227268
闔��ｺ陷ｿ�｣鬮ｮ�ｽ�ｸ�ｭ陜ｨ�ｰ陋ｹ�ｺ闔会ｽ･陞滓じ�ｽ陜ｨ�ｰ陋ｹ�ｺ,陝ｷ�ｳ隰鯉ｿｽ,7,1995,,44315576,21546996,22768580
陋ｹ邇ｲ�ｵ�ｷ鬩包ｿｽ,陝ｷ�ｳ隰鯉ｿｽ,7,1995,,5692321,2736844,2955477
鬮ｱ蜻茨ｽ｣�ｮ騾ｵ�ｽ,陝ｷ�ｳ隰鯉ｿｽ,7,1995,,1481663,704189,777474
陝ｯ�ｩ隰�距諱�,陝ｷ�ｳ隰鯉ｿｽ,7,1995,,1419505,681986,737519
陞ｳ�ｮ陜灘ｮ域＝,陝ｷ�ｳ隰鯉ｿｽ,7,1995,,2328739,1144739,1184000
驕倡距莨宣ｵ�ｽ,陝ｷ�ｳ隰鯉ｿｽ,7,1995,,1213667,577535,636132
陞ｻ�ｱ陟厄ｽ｢騾ｵ�ｽ,陝ｷ�ｳ隰鯉ｿｽ,7,1995,,1256958,607316,649642
驕紋ｸ橸ｽｳ�ｶ騾ｵ�ｽ,陝ｷ�ｳ隰鯉ｿｽ,7,1995,,2133592,1042030,1091562
髣鯉ｽｨ陜灘ｮ域＝,陝ｷ�ｳ隰鯉ｿｽ,7,1995,,2955530,1476437,1479093
隴ｬ�ｽ諠�騾ｵ�ｽ,陝ｷ�ｳ隰鯉ｿｽ,7,1995,,1984390,987426,996964
驗抵ｽ､鬯･�ｬ騾ｵ�ｽ,陝ｷ�ｳ隰鯉ｿｽ,7,1995,,2003540,989610,1013930
陜難ｽｼ驍��諱�,陝ｷ�ｳ隰鯉ｿｽ,7,1995,,6759311,3419218,3340093
陷奇ｿｽ逞ｩ騾ｵ�ｽ,陝ｷ�ｳ隰鯉ｿｽ,7,1995,,5797782,2923839,2873943
隴夲ｽｱ闔��ｬ鬩幢ｽｽ,陝ｷ�ｳ隰鯉ｿｽ,7,1995,,11773605,5892704,5880901
騾ｾ讒ｫ�･莠･�ｷ譎画＝,陝ｷ�ｳ隰鯉ｿｽ,7,1995,,8245900,4209525,4036375
隴�ｽｰ雋取ｺｽ諱�,陝ｷ�ｳ隰鯉ｿｽ,7,1995,,2488364,1209833,1278531
陝�ぁ�ｱ�ｱ騾ｵ�ｽ,陝ｷ�ｳ隰鯉ｿｽ,7,1995,,1123125,540921,582204
驕擾ｽｳ陝ｾ譎画＝,陝ｷ�ｳ隰鯉ｿｽ,7,1995,,1180068,570835,609233
驕紋ｸ茨ｽｺ諷墓＝,陝ｷ�ｳ隰鯉ｿｽ,7,1995,,826996,401860,425136
陞ｻ�ｱ隴ｴ�ｨ騾ｵ�ｽ,陝ｷ�ｳ隰鯉ｿｽ,7,1995,,881996,434707,447289
鬮滂ｽｷ鬩･螳域＝,陝ｷ�ｳ隰鯉ｿｽ,7,1995,,2193984,1070471,1123513
陝ｯ螳｣�ｽ騾ｵ�ｽ,陝ｷ�ｳ隰鯉ｿｽ,7,1995,,2100315,1019549,1080766
鬮ｱ蜷晢ｽｲ�｡騾ｵ�ｽ,陝ｷ�ｳ隰鯉ｿｽ,7,1995,,3737689,1841947,1895742
隲｢蟶ｷ陦埼ｵ�ｽ,陝ｷ�ｳ隰鯉ｿｽ,7,1995,,6868336,3439180,3429156
闕ｳ陋ｾ纃ｾ騾ｵ�ｽ,陝ｷ�ｳ隰鯉ｿｽ,7,1995,,1841358,893982,947376
雋顔事�ｳﾂ騾ｵ�ｽ,陝ｷ�ｳ隰鯉ｿｽ,7,1995,,1287005,634648,652357
闔��ｬ鬩幢ｽｽ陟趣ｿｽ,陝ｷ�ｳ隰鯉ｿｽ,7,1995,,2629592,1276838,1352754
陞滂ｽｧ鬮ｦ�ｪ陟趣ｿｽ,陝ｷ�ｳ隰鯉ｿｽ,7,1995,,8797268,4321575,4475693
陷茨ｽｵ陟趣ｽｫ騾ｵ�ｽ,陝ｷ�ｳ隰鯉ｿｽ,7,1995,,5401877,2612369,2789508
陞るメ諞ｶ騾ｵ�ｽ,陝ｷ�ｳ隰鯉ｿｽ,7,1995,,1430862,688741,742121
陷･譴ｧ�ｭ謔滂ｽｱ�ｱ騾ｵ�ｽ,陝ｷ�ｳ隰鯉ｿｽ,7,1995,,1080435,513450,566985
鬲托ｽ･陷ｿ荵滓＝,陝ｷ�ｳ隰鯉ｿｽ,7,1995,,614929,294414,320515
陝ｲ�ｶ隴ｬ�ｹ騾ｵ�ｽ,陝ｷ�ｳ隰鯉ｿｽ,7,1995,,771441,368789,402652
陝ｯ�｡陞ｻ�ｱ騾ｵ�ｽ,陝ｷ�ｳ隰鯉ｿｽ,7,1995,,1950750,938439,1012311
陟趣ｿｽ�ｳ�ｶ騾ｵ�ｽ,陝ｷ�ｳ隰鯉ｿｽ,7,1995,,2881748,1398986,1482762
陞ｻ�ｱ陷ｿ�｣騾ｵ�ｽ,陝ｷ�ｳ隰鯉ｿｽ,7,1995,,1555543,736555,818988
陟包ｽｳ陝ｲ�ｶ騾ｵ�ｽ,陝ｷ�ｳ隰鯉ｿｽ,7,1995,,832427,395636,436791
鬯･蜷晢ｽｷ譎画＝,陝ｷ�ｳ隰鯉ｿｽ,7,1995,,1027006,493482,533524
隲｢蟶幢ｽｪ蟶ｷ諱�,陝ｷ�ｳ隰鯉ｿｽ,7,1995,,1506700,712518,794182
鬯ｮ蛟｡陦埼ｵ�ｽ,陝ｷ�ｳ隰鯉ｿｽ,7,1995,,816704,384446,432258
驕紋ｸ橸ｽｲ�｡騾ｵ�ｽ,陝ｷ�ｳ隰鯉ｿｽ,7,1995,,4933393,2357525,2575868
闖ｴ蜊��ｳﾂ騾ｵ�ｽ,陝ｷ�ｳ隰鯉ｿｽ,7,1995,,884316,418666,465650
鬮滂ｽｷ陝�螳域＝,陝ｷ�ｳ隰鯉ｿｽ,7,1995,,1544934,726894,818040
霎ｭ鬆第た騾ｵ�ｽ,陝ｷ�ｳ隰鯉ｿｽ,7,1995,,1859793,879873,979920
陞滂ｽｧ陋ｻ�ｽ諱�,陝ｷ�ｳ隰鯉ｿｽ,7,1995,,1231306,581909,649397
陞ｳ�ｮ陝�螳域＝,陝ｷ�ｳ隰鯉ｿｽ,7,1995,,1175819,556245,619574
魄厄ｽｿ陷井ｻ呻ｽｳ�ｶ騾ｵ�ｽ,陝ｷ�ｳ隰鯉ｿｽ,7,1995,,1794224,840980,953244
雎蝉ｹ滂ｽｸ�ｽ諱�,陝ｷ�ｳ隰鯉ｿｽ,7,1995,,1273440,624737,648703
陷茨ｽｨ陜暦ｽｽ,陝ｷ�ｳ隰鯉ｿｽ,12,2000,,126925843,62110764,64815079
闔��ｺ陷ｿ�｣鬮ｮ�ｽ�ｸ�ｭ陜ｨ�ｰ陋ｹ�ｺ,陝ｷ�ｳ隰鯉ｿｽ,12,2000,,82809682,40709080,42100602
闔��ｺ陷ｿ�｣鬮ｮ�ｽ�ｸ�ｭ陜ｨ�ｰ陋ｹ�ｺ闔会ｽ･陞滓じ�ｽ陜ｨ�ｰ陋ｹ�ｺ,陝ｷ�ｳ隰鯉ｿｽ,12,2000,,44116161,21401684,22714477
陋ｹ邇ｲ�ｵ�ｷ鬩包ｿｽ,陝ｷ�ｳ隰鯉ｿｽ,12,2000,,5683062,2719389,2963673
鬮ｱ蜻茨ｽ｣�ｮ騾ｵ�ｽ,陝ｷ�ｳ隰鯉ｿｽ,12,2000,,1475728,702573,773155
陝ｯ�ｩ隰�距諱�,陝ｷ�ｳ隰鯉ｿｽ,12,2000,,1416180,681238,734942
陞ｳ�ｮ陜灘ｮ域＝,陝ｷ�ｳ隰鯉ｿｽ,12,2000,,2365320,1158622,1206698
驕倡距莨宣ｵ�ｽ,陝ｷ�ｳ隰鯉ｿｽ,12,2000,,1189279,564556,624723
陞ｻ�ｱ陟厄ｽ｢騾ｵ�ｽ,陝ｷ�ｳ隰鯉ｿｽ,12,2000,,1244147,601372,642775
驕紋ｸ橸ｽｳ�ｶ騾ｵ�ｽ,陝ｷ�ｳ隰鯉ｿｽ,12,2000,,2126935,1037787,1089148
髣鯉ｽｨ陜灘ｮ域＝,陝ｷ�ｳ隰鯉ｿｽ,12,2000,,2985676,1488340,1497336
隴ｬ�ｽ諠�騾ｵ�ｽ,陝ｷ�ｳ隰鯉ｿｽ,12,2000,,2004817,995859,1008958
驗抵ｽ､鬯･�ｬ騾ｵ�ｽ,陝ｷ�ｳ隰鯉ｿｽ,12,2000,,2024852,999349,1025503
陜難ｽｼ驍��諱�,陝ｷ�ｳ隰鯉ｿｽ,12,2000,,6938006,3500224,3437782
陷奇ｿｽ逞ｩ騾ｵ�ｽ,陝ｷ�ｳ隰鯉ｿｽ,12,2000,,5926285,2976984,2949301
隴夲ｽｱ闔��ｬ鬩幢ｽｽ,陝ｷ�ｳ隰鯉ｿｽ,12,2000,,12064101,6028562,6035539
騾ｾ讒ｫ�･莠･�ｷ譎画＝,陝ｷ�ｳ隰鯉ｿｽ,12,2000,,8489974,4308786,4181188
隴�ｽｰ雋取ｺｽ諱�,陝ｷ�ｳ隰鯉ｿｽ,12,2000,,2475733,1202004,1273729
陝�ぁ�ｱ�ｱ騾ｵ�ｽ,陝ｷ�ｳ隰鯉ｿｽ,12,2000,,1120851,540212,580639
驕擾ｽｳ陝ｾ譎画＝,陝ｷ�ｳ隰鯉ｿｽ,12,2000,,1180977,572244,608733
驕紋ｸ茨ｽｺ諷墓＝,陝ｷ�ｳ隰鯉ｿｽ,12,2000,,828944,402367,426577
陞ｻ�ｱ隴ｴ�ｨ騾ｵ�ｽ,陝ｷ�ｳ隰鯉ｿｽ,12,2000,,888172,436837,451335
鬮滂ｽｷ鬩･螳域＝,陝ｷ�ｳ隰鯉ｿｽ,12,2000,,2215168,1080986,1134182
陝ｯ螳｣�ｽ騾ｵ�ｽ,陝ｷ�ｳ隰鯉ｿｽ,12,2000,,2107700,1022186,1085514
鬮ｱ蜷晢ｽｲ�｡騾ｵ�ｽ,陝ｷ�ｳ隰鯉ｿｽ,12,2000,,3767393,1857031,1910362
隲｢蟶ｷ陦埼ｵ�ｽ,陝ｷ�ｳ隰鯉ｿｽ,12,2000,,7043300,3525698,3517602
闕ｳ陋ｾ纃ｾ騾ｵ�ｽ,陝ｷ�ｳ隰鯉ｿｽ,12,2000,,1857339,901380,955959
雋顔事�ｳﾂ騾ｵ�ｽ,陝ｷ�ｳ隰鯉ｿｽ,12,2000,,1342832,663432,679400
闔��ｬ鬩幢ｽｽ陟趣ｿｽ,陝ｷ�ｳ隰鯉ｿｽ,12,2000,,2644391,1278142,1366249
陞滂ｽｧ鬮ｦ�ｪ陟趣ｿｽ,陝ｷ�ｳ隰鯉ｿｽ,12,2000,,8805081,4304059,4501022
陷茨ｽｵ陟趣ｽｫ騾ｵ�ｽ,陝ｷ�ｳ隰鯉ｿｽ,12,2000,,5550574,2674625,2875949
陞るメ諞ｶ騾ｵ�ｽ,陝ｷ�ｳ隰鯉ｿｽ,12,2000,,1442795,691098,751697
陷･譴ｧ�ｭ謔滂ｽｱ�ｱ騾ｵ�ｽ,陝ｷ�ｳ隰鯉ｿｽ,12,2000,,1069912,506882,563030
鬲托ｽ･陷ｿ荵滓＝,陝ｷ�ｳ隰鯉ｿｽ,12,2000,,613289,293403,319886
陝ｲ�ｶ隴ｬ�ｹ騾ｵ�ｽ,陝ｷ�ｳ隰鯉ｿｽ,12,2000,,761503,363994,397509
陝ｯ�｡陞ｻ�ｱ騾ｵ�ｽ,陝ｷ�ｳ隰鯉ｿｽ,12,2000,,1950828,936044,1014784
陟趣ｿｽ�ｳ�ｶ騾ｵ�ｽ,陝ｷ�ｳ隰鯉ｿｽ,12,2000,,2878915,1392496,1486419
陞ｻ�ｱ陷ｿ�｣騾ｵ�ｽ,陝ｷ�ｳ隰鯉ｿｽ,12,2000,,1527964,722683,805281
陟包ｽｳ陝ｲ�ｶ騾ｵ�ｽ,陝ｷ�ｳ隰鯉ｿｽ,12,2000,,824108,391718,432390
鬯･蜷晢ｽｷ譎画＝,陝ｷ�ｳ隰鯉ｿｽ,12,2000,,1022890,491761,531129
隲｢蟶幢ｽｪ蟶ｷ諱�,陝ｷ�ｳ隰鯉ｿｽ,12,2000,,1493092,704289,788803
鬯ｮ蛟｡陦埼ｵ�ｽ,陝ｷ�ｳ隰鯉ｿｽ,12,2000,,813949,383859,430090
驕紋ｸ橸ｽｲ�｡騾ｵ�ｽ,陝ｷ�ｳ隰鯉ｿｽ,12,2000,,5015699,2388824,2626875
闖ｴ蜊��ｳﾂ騾ｵ�ｽ,陝ｷ�ｳ隰鯉ｿｽ,12,2000,,876654,414377,462277
鬮滂ｽｷ陝�螳域＝,陝ｷ�ｳ隰鯉ｿｽ,12,2000,,1516523,712346,804177
霎ｭ鬆第た騾ｵ�ｽ,陝ｷ�ｳ隰鯉ｿｽ,12,2000,,1859344,878145,981199
陞滂ｽｧ陋ｻ�ｽ諱�,陝ｷ�ｳ隰鯉ｿｽ,12,2000,,1221140,575985,645155
陞ｳ�ｮ陝�螳域＝,陝ｷ�ｳ隰鯉ｿｽ,12,2000,,1170007,552160,617847
魄厄ｽｿ陷井ｻ呻ｽｳ�ｶ騾ｵ�ｽ,陝ｷ�ｳ隰鯉ｿｽ,12,2000,,1786194,837979,948215
雎蝉ｹ滂ｽｸ�ｽ諱�,陝ｷ�ｳ隰鯉ｿｽ,12,2000,,1318220,647877,670343
陷茨ｽｨ陜暦ｽｽ,陝ｷ�ｳ隰鯉ｿｽ,17,2005,,127767994,62348977,65419017
闔��ｺ陷ｿ�｣鬮ｮ�ｽ�ｸ�ｭ陜ｨ�ｰ陋ｹ�ｺ,陝ｷ�ｳ隰鯉ｿｽ,17,2005,,84331415,41327595,43003820
闔��ｺ陷ｿ�｣鬮ｮ�ｽ�ｸ�ｭ陜ｨ�ｰ陋ｹ�ｺ闔会ｽ･陞滓じ�ｽ陜ｨ�ｰ陋ｹ�ｺ,陝ｷ�ｳ隰鯉ｿｽ,17,2005,,43436579,21021382,22415197
陋ｹ邇ｲ�ｵ�ｷ鬩包ｿｽ,陝ｷ�ｳ隰鯉ｿｽ,17,2005,,5627737,2675033,2952704
鬮ｱ蜻茨ｽ｣�ｮ騾ｵ�ｽ,陝ｷ�ｳ隰鯉ｿｽ,17,2005,,1436657,679077,757580
陝ｯ�ｩ隰�距諱�,陝ｷ�ｳ隰鯉ｿｽ,17,2005,,1385041,663580,721461
陞ｳ�ｮ陜灘ｮ域＝,陝ｷ�ｳ隰鯉ｿｽ,17,2005,,2360218,1149172,1211046
驕倡距莨宣ｵ�ｽ,陝ｷ�ｳ隰鯉ｿｽ,17,2005,,1145501,540539,604962
陞ｻ�ｱ陟厄ｽ｢騾ｵ�ｽ,陝ｷ�ｳ隰鯉ｿｽ,17,2005,,1216181,585023,631158
驕紋ｸ橸ｽｳ�ｶ騾ｵ�ｽ,陝ｷ�ｳ隰鯉ｿｽ,17,2005,,2091319,1016724,1074595
髣鯉ｽｨ陜灘ｮ域＝,陝ｷ�ｳ隰鯉ｿｽ,17,2005,,2975167,1479941,1495226
隴ｬ�ｽ諠�騾ｵ�ｽ,陝ｷ�ｳ隰鯉ｿｽ,17,2005,,2016631,1002114,1014517
驗抵ｽ､鬯･�ｬ騾ｵ�ｽ,陝ｷ�ｳ隰鯉ｿｽ,17,2005,,2024135,996346,1027789
陜難ｽｼ驍��諱�,陝ｷ�ｳ隰鯉ｿｽ,17,2005,,7054243,3554843,3499400
陷奇ｿｽ逞ｩ騾ｵ�ｽ,陝ｷ�ｳ隰鯉ｿｽ,17,2005,,6056462,3029486,3026976
隴夲ｽｱ闔��ｬ鬩幢ｽｽ,陝ｷ�ｳ隰鯉ｿｽ,17,2005,,12576601,6264895,6311706
騾ｾ讒ｫ�･莠･�ｷ譎画＝,陝ｷ�ｳ隰鯉ｿｽ,17,2005,,8791597,4444555,4347042
隴�ｽｰ雋取ｺｽ諱�,陝ｷ�ｳ隰鯉ｿｽ,17,2005,,2431459,1176919,1254540
陝�ぁ�ｱ�ｱ騾ｵ�ｽ,陝ｷ�ｳ隰鯉ｿｽ,17,2005,,1111729,535617,576112
驕擾ｽｳ陝ｾ譎画＝,陝ｷ�ｳ隰鯉ｿｽ,17,2005,,1174026,567060,606966
驕紋ｸ茨ｽｺ諷墓＝,陝ｷ�ｳ隰鯉ｿｽ,17,2005,,821592,397271,424321
陞ｻ�ｱ隴ｴ�ｨ騾ｵ�ｽ,陝ｷ�ｳ隰鯉ｿｽ,17,2005,,884515,433569,450946
鬮滂ｽｷ鬩･螳域＝,陝ｷ�ｳ隰鯉ｿｽ,17,2005,,2196114,1068203,1127911
陝ｯ螳｣�ｽ騾ｵ�ｽ,陝ｷ�ｳ隰鯉ｿｽ,17,2005,,2107226,1020570,1086656
鬮ｱ蜷晢ｽｲ�｡騾ｵ�ｽ,陝ｷ�ｳ隰鯉ｿｽ,17,2005,,3792377,1868458,1923919
隲｢蟶ｷ陦埼ｵ�ｽ,陝ｷ�ｳ隰鯉ｿｽ,17,2005,,7254704,3638994,3615710
闕ｳ陋ｾ纃ｾ騾ｵ�ｽ,陝ｷ�ｳ隰鯉ｿｽ,17,2005,,1866963,907214,959749
雋顔事�ｳﾂ騾ｵ�ｽ,陝ｷ�ｳ隰鯉ｿｽ,17,2005,,1380361,681474,698887
闔��ｬ鬩幢ｽｽ陟趣ｿｽ,陝ｷ�ｳ隰鯉ｿｽ,17,2005,,2647660,1272993,1374667
陞滂ｽｧ鬮ｦ�ｪ陟趣ｿｽ,陝ｷ�ｳ隰鯉ｿｽ,17,2005,,8817166,4280622,4536544
陷茨ｽｵ陟趣ｽｫ騾ｵ�ｽ,陝ｷ�ｳ隰鯉ｿｽ,17,2005,,5590601,2680288,2910313
陞るメ諞ｶ騾ｵ�ｽ,陝ｷ�ｳ隰鯉ｿｽ,17,2005,,1421310,676375,744935
陷･譴ｧ�ｭ謔滂ｽｱ�ｱ騾ｵ�ｽ,陝ｷ�ｳ隰鯉ｿｽ,17,2005,,1035969,488022,547947
鬲托ｽ･陷ｿ荵滓＝,陝ｷ�ｳ隰鯉ｿｽ,17,2005,,607012,290190,316822
陝ｲ�ｶ隴ｬ�ｹ騾ｵ�ｽ,陝ｷ�ｳ隰鯉ｿｽ,17,2005,,742223,353703,388520
陝ｯ�｡陞ｻ�ｱ騾ｵ�ｽ,陝ｷ�ｳ隰鯉ｿｽ,17,2005,,1957264,938600,1018664
陟趣ｿｽ�ｳ�ｶ騾ｵ�ｽ,陝ｷ�ｳ隰鯉ｿｽ,17,2005,,2876642,1390190,1486452
陞ｻ�ｱ陷ｿ�｣騾ｵ�ｽ,陝ｷ�ｳ隰鯉ｿｽ,17,2005,,1492606,703721,788885
陟包ｽｳ陝ｲ�ｶ騾ｵ�ｽ,陝ｷ�ｳ隰鯉ｿｽ,17,2005,,809950,384635,425315
鬯･蜷晢ｽｷ譎画＝,陝ｷ�ｳ隰鯉ｿｽ,17,2005,,1012400,486108,526292
隲｢蟶幢ｽｪ蟶ｷ諱�,陝ｷ�ｳ隰鯉ｿｽ,17,2005,,1467815,691677,776138
鬯ｮ蛟｡陦埼ｵ�ｽ,陝ｷ�ｳ隰鯉ｿｽ,17,2005,,796292,374435,421857
驕紋ｸ橸ｽｲ�｡騾ｵ�ｽ,陝ｷ�ｳ隰鯉ｿｽ,17,2005,,5049908,2394094,2655814
闖ｴ蜊��ｳﾂ騾ｵ�ｽ,陝ｷ�ｳ隰鯉ｿｽ,17,2005,,866369,408230,458139
鬮滂ｽｷ陝�螳域＝,陝ｷ�ｳ隰鯉ｿｽ,17,2005,,1478632,691444,787188
霎ｭ鬆第た騾ｵ�ｽ,陝ｷ�ｳ隰鯉ｿｽ,17,2005,,1842233,866916,975317
陞滂ｽｧ陋ｻ�ｽ諱�,陝ｷ�ｳ隰鯉ｿｽ,17,2005,,1209571,569796,639775
陞ｳ�ｮ陝�螳域＝,陝ｷ�ｳ隰鯉ｿｽ,17,2005,,1153042,542113,610929
魄厄ｽｿ陷井ｻ呻ｽｳ�ｶ騾ｵ�ｽ,陝ｷ�ｳ隰鯉ｿｽ,17,2005,,1753179,819646,933533
雎蝉ｹ滂ｽｸ�ｽ諱�,陝ｷ�ｳ隰鯉ｿｽ,17,2005,,1361594,668502,693092
陷茨ｽｨ陜暦ｽｽ,陝ｷ�ｳ隰鯉ｿｽ,22,2010,,128057352,62327737,65729615
闔��ｺ陷ｿ�｣鬮ｮ�ｽ�ｸ�ｭ陜ｨ�ｰ陋ｹ�ｺ,陝ｷ�ｳ隰鯉ｿｽ,22,2010,,86121462,42051390,44070072
闔��ｺ陷ｿ�｣鬮ｮ�ｽ�ｸ�ｭ陜ｨ�ｰ陋ｹ�ｺ闔会ｽ･陞滓じ�ｽ陜ｨ�ｰ陋ｹ�ｺ,陝ｷ�ｳ隰鯉ｿｽ,22,2010,,41935890,20276347,21659543
陋ｹ邇ｲ�ｵ�ｷ鬩包ｿｽ,陝ｷ�ｳ隰鯉ｿｽ,22,2010,,5506419,2603345,2903074
鬮ｱ蜻茨ｽ｣�ｮ騾ｵ�ｽ,陝ｷ�ｳ隰鯉ｿｽ,22,2010,,1373339,646141,727198
陝ｯ�ｩ隰�距諱�,陝ｷ�ｳ隰鯉ｿｽ,22,2010,,1330147,634971,695176
陞ｳ�ｮ陜灘ｮ域＝,陝ｷ�ｳ隰鯉ｿｽ,22,2010,,2348165,1139566,1208599
驕倡距莨宣ｵ�ｽ,陝ｷ�ｳ隰鯉ｿｽ,22,2010,,1085997,509926,576071
陞ｻ�ｱ陟厄ｽ｢騾ｵ�ｽ,陝ｷ�ｳ隰鯉ｿｽ,22,2010,,1168924,560643,608281
驕紋ｸ橸ｽｳ�ｶ騾ｵ�ｽ,陝ｷ�ｳ隰鯉ｿｽ,22,2010,,2029064,984682,1044382
髣鯉ｽｨ陜灘ｮ域＝,陝ｷ�ｳ隰鯉ｿｽ,22,2010,,2969770,1479779,1489991
隴ｬ�ｽ諠�騾ｵ�ｽ,陝ｷ�ｳ隰鯉ｿｽ,22,2010,,2007683,996855,1010828
驗抵ｽ､鬯･�ｬ騾ｵ�ｽ,陝ｷ�ｳ隰鯉ｿｽ,22,2010,,2008068,988019,1020049
陜難ｽｼ驍��諱�,陝ｷ�ｳ隰鯉ｿｽ,22,2010,,7194556,3608711,3585845
陷奇ｿｽ逞ｩ騾ｵ�ｽ,陝ｷ�ｳ隰鯉ｿｽ,22,2010,,6216289,3098139,3118150
隴夲ｽｱ闔��ｬ鬩幢ｽｽ,陝ｷ�ｳ隰鯉ｿｽ,22,2010,,13159388,6512110,6647278
騾ｾ讒ｫ�･莠･�ｷ譎画＝,陝ｷ�ｳ隰鯉ｿｽ,22,2010,,9048331,4544545,4503786
隴�ｽｰ雋取ｺｽ諱�,陝ｷ�ｳ隰鯉ｿｽ,22,2010,,2374450,1148236,1226214
陝�ぁ�ｱ�ｱ騾ｵ�ｽ,陝ｷ�ｳ隰鯉ｿｽ,22,2010,,1093247,526605,566642
驕擾ｽｳ陝ｾ譎画＝,陝ｷ�ｳ隰鯉ｿｽ,22,2010,,1169788,564972,604816
驕紋ｸ茨ｽｺ諷墓＝,陝ｷ�ｳ隰鯉ｿｽ,22,2010,,806314,389712,416602
陞ｻ�ｱ隴ｴ�ｨ騾ｵ�ｽ,陝ｷ�ｳ隰鯉ｿｽ,22,2010,,863075,422526,440549
鬮滂ｽｷ鬩･螳域＝,陝ｷ�ｳ隰鯉ｿｽ,22,2010,,2152449,1046178,1106271
陝ｯ螳｣�ｽ騾ｵ�ｽ,陝ｷ�ｳ隰鯉ｿｽ,22,2010,,2080773,1006247,1074526
鬮ｱ蜷晢ｽｲ�｡騾ｵ�ｽ,陝ｷ�ｳ隰鯉ｿｽ,22,2010,,3765007,1853952,1911055
隲｢蟶ｷ陦埼ｵ�ｽ,陝ｷ�ｳ隰鯉ｿｽ,22,2010,,7410719,3704220,3706499
闕ｳ陋ｾ纃ｾ騾ｵ�ｽ,陝ｷ�ｳ隰鯉ｿｽ,22,2010,,1854724,903398,951326
雋顔事�ｳﾂ騾ｵ�ｽ,陝ｷ�ｳ隰鯉ｿｽ,22,2010,,1410777,696769,714008
闔��ｬ鬩幢ｽｽ陟趣ｿｽ,陝ｷ�ｳ隰鯉ｿｽ,22,2010,,2636092,1265387,1370705
陞滂ｽｧ鬮ｦ�ｪ陟趣ｿｽ,陝ｷ�ｳ隰鯉ｿｽ,22,2010,,8865245,4285566,4579679
陷茨ｽｵ陟趣ｽｫ騾ｵ�ｽ,陝ｷ�ｳ隰鯉ｿｽ,22,2010,,5588133,2673328,2914805
陞るメ諞ｶ騾ｵ�ｽ,陝ｷ�ｳ隰鯉ｿｽ,22,2010,,1400728,663321,737407
陷･譴ｧ�ｭ謔滂ｽｱ�ｱ騾ｵ�ｽ,陝ｷ�ｳ隰鯉ｿｽ,22,2010,,1002198,471397,530801
鬲托ｽ･陷ｿ荵滓＝,陝ｷ�ｳ隰鯉ｿｽ,22,2010,,588667,280701,307966
陝ｲ�ｶ隴ｬ�ｹ騾ｵ�ｽ,陝ｷ�ｳ隰鯉ｿｽ,22,2010,,717397,342991,374406
陝ｯ�｡陞ｻ�ｱ騾ｵ�ｽ,陝ｷ�ｳ隰鯉ｿｽ,22,2010,,1945276,933168,1012108
陟趣ｿｽ�ｳ�ｶ騾ｵ�ｽ,陝ｷ�ｳ隰鯉ｿｽ,22,2010,,2860750,1380671,1480079
陞ｻ�ｱ陷ｿ�｣騾ｵ�ｽ,陝ｷ�ｳ隰鯉ｿｽ,22,2010,,1451338,684176,767162
陟包ｽｳ陝ｲ�ｶ騾ｵ�ｽ,陝ｷ�ｳ隰鯉ｿｽ,22,2010,,785491,372710,412781
鬯･蜷晢ｽｷ譎画＝,陝ｷ�ｳ隰鯉ｿｽ,22,2010,,995842,479951,515891
隲｢蟶幢ｽｪ蟶ｷ諱�,陝ｷ�ｳ隰鯉ｿｽ,22,2010,,1431493,673326,758167
鬯ｮ蛟｡陦埼ｵ�ｽ,陝ｷ�ｳ隰鯉ｿｽ,22,2010,,764456,359134,405322
驕紋ｸ橸ｽｲ�｡騾ｵ�ｽ,陝ｷ�ｳ隰鯉ｿｽ,22,2010,,5071968,2393965,2678003
闖ｴ蜊��ｳﾂ騾ｵ�ｽ,陝ｷ�ｳ隰鯉ｿｽ,22,2010,,849788,400136,449652
鬮滂ｽｷ陝�螳域＝,陝ｷ�ｳ隰鯉ｿｽ,22,2010,,1426779,665899,760880
霎ｭ鬆第た騾ｵ�ｽ,陝ｷ�ｳ隰鯉ｿｽ,22,2010,,1817426,853514,963912
陞滂ｽｧ陋ｻ�ｽ諱�,陝ｷ�ｳ隰鯉ｿｽ,22,2010,,1196529,564890,631639
陞ｳ�ｮ陝�螳域＝,陝ｷ�ｳ隰鯉ｿｽ,22,2010,,1135233,533035,602198
魄厄ｽｿ陷井ｻ呻ｽｳ�ｶ騾ｵ�ｽ,陝ｷ�ｳ隰鯉ｿｽ,22,2010,,1706242,796896,909346
雎蝉ｹ滂ｽｸ�ｽ諱�,陝ｷ�ｳ隰鯉ｿｽ,22,2010,,1392818,683328,709490
陷茨ｽｨ陜暦ｽｽ,陝ｷ�ｳ隰鯉ｿｽ,27,2015,,127094745,61841738,65253007
闔��ｺ陷ｿ�｣鬮ｮ�ｽ�ｸ�ｭ陜ｨ�ｰ陋ｹ�ｺ,陝ｷ�ｳ隰鯉ｿｽ,27,2015,,86868176,42363423,44504753
闔��ｺ陷ｿ�｣鬮ｮ�ｽ�ｸ�ｭ陜ｨ�ｰ陋ｹ�ｺ闔会ｽ･陞滓じ�ｽ陜ｨ�ｰ陋ｹ�ｺ,陝ｷ�ｳ隰鯉ｿｽ,27,2015,,40226569,19478315,20748254
陋ｹ邇ｲ�ｵ�ｷ鬩包ｿｽ,陝ｷ�ｳ隰鯉ｿｽ,27,2015,,5381733,2537089,2844644
鬮ｱ蜻茨ｽ｣�ｮ騾ｵ�ｽ,陝ｷ�ｳ隰鯉ｿｽ,27,2015,,1308265,614694,693571
陝ｯ�ｩ隰�距諱�,陝ｷ�ｳ隰鯉ｿｽ,27,2015,,1279594,615584,664010
陞ｳ�ｮ陜灘ｮ域＝,陝ｷ�ｳ隰鯉ｿｽ,27,2015,,2333899,1140167,1193732
驕倡距莨宣ｵ�ｽ,陝ｷ�ｳ隰鯉ｿｽ,27,2015,,1023119,480336,542783
陞ｻ�ｱ陟厄ｽ｢騾ｵ�ｽ,陝ｷ�ｳ隰鯉ｿｽ,27,2015,,1123891,540226,583665
驕紋ｸ橸ｽｳ�ｶ騾ｵ�ｽ,陝ｷ�ｳ隰鯉ｿｽ,27,2015,,1914039,945660,968379
髣鯉ｽｨ陜灘ｮ域＝,陝ｷ�ｳ隰鯉ｿｽ,27,2015,,2916976,1453594,1463382
隴ｬ�ｽ諠�騾ｵ�ｽ,陝ｷ�ｳ隰鯉ｿｽ,27,2015,,1974255,981626,992629
驗抵ｽ､鬯･�ｬ騾ｵ�ｽ,陝ｷ�ｳ隰鯉ｿｽ,27,2015,,1973115,973283,999832
陜難ｽｼ驍��諱�,陝ｷ�ｳ隰鯉ｿｽ,27,2015,,7266534,3628418,3638116
陷奇ｿｽ逞ｩ騾ｵ�ｽ,陝ｷ�ｳ隰鯉ｿｽ,27,2015,,6222666,3095860,3126806
隴夲ｽｱ闔��ｬ鬩幢ｽｽ,陝ｷ�ｳ隰鯉ｿｽ,27,2015,,13515271,6666690,6848581
騾ｾ讒ｫ�･莠･�ｷ譎画＝,陝ｷ�ｳ隰鯉ｿｽ,27,2015,,9126214,4558978,4567236
隴�ｽｰ雋取ｺｽ諱�,陝ｷ�ｳ隰鯉ｿｽ,27,2015,,2304264,1115413,1188851
陝�ぁ�ｱ�ｱ騾ｵ�ｽ,陝ｷ�ｳ隰鯉ｿｽ,27,2015,,1066328,515147,551181
驕擾ｽｳ陝ｾ譎画＝,陝ｷ�ｳ隰鯉ｿｽ,27,2015,,1154008,558589,595419
驕紋ｸ茨ｽｺ諷墓＝,陝ｷ�ｳ隰鯉ｿｽ,27,2015,,786740,381474,405266
陞ｻ�ｱ隴ｴ�ｨ騾ｵ�ｽ,陝ｷ�ｳ隰鯉ｿｽ,27,2015,,834930,408327,426603
鬮滂ｽｷ鬩･螳域＝,陝ｷ�ｳ隰鯉ｿｽ,27,2015,,2098804,1022129,1076675
陝ｯ螳｣�ｽ騾ｵ�ｽ,陝ｷ�ｳ隰鯉ｿｽ,27,2015,,2031903,983850,1048053
鬮ｱ蜷晢ｽｲ�｡騾ｵ�ｽ,陝ｷ�ｳ隰鯉ｿｽ,27,2015,,3700305,1820993,1879312
隲｢蟶ｷ陦埼ｵ�ｽ,陝ｷ�ｳ隰鯉ｿｽ,27,2015,,7483128,3740844,3742284
闕ｳ陋ｾ纃ｾ騾ｵ�ｽ,陝ｷ�ｳ隰鯉ｿｽ,27,2015,,1815865,883516,932349
雋顔事�ｳﾂ騾ｵ�ｽ,陝ｷ�ｳ隰鯉ｿｽ,27,2015,,1412916,696941,715975
闔��ｬ鬩幢ｽｽ陟趣ｿｽ,陝ｷ�ｳ隰鯉ｿｽ,27,2015,,2610353,1248972,1361381
陞滂ｽｧ鬮ｦ�ｪ陟趣ｿｽ,陝ｷ�ｳ隰鯉ｿｽ,27,2015,,8839469,4256049,4583420
陷茨ｽｵ陟趣ｽｫ騾ｵ�ｽ,陝ｷ�ｳ隰鯉ｿｽ,27,2015,,5534800,2641561,2893239
陞るメ諞ｶ騾ｵ�ｽ,陝ｷ�ｳ隰鯉ｿｽ,27,2015,,1364316,643946,720370
陷･譴ｧ�ｭ謔滂ｽｱ�ｱ騾ｵ�ｽ,陝ｷ�ｳ隰鯉ｿｽ,27,2015,,963579,453216,510363
鬲托ｽ･陷ｿ荵滓＝,陝ｷ�ｳ隰鯉ｿｽ,27,2015,,573441,273705,299736
陝ｲ�ｶ隴ｬ�ｹ騾ｵ�ｽ,陝ｷ�ｳ隰鯉ｿｽ,27,2015,,694352,333112,361240
陝ｯ�｡陞ｻ�ｱ騾ｵ�ｽ,陝ｷ�ｳ隰鯉ｿｽ,27,2015,,1921525,922226,999299
陟趣ｿｽ�ｳ�ｶ騾ｵ�ｽ,陝ｷ�ｳ隰鯉ｿｽ,27,2015,,2843990,1376211,1467779
陞ｻ�ｱ陷ｿ�｣騾ｵ�ｽ,陝ｷ�ｳ隰鯉ｿｽ,27,2015,,1404729,665008,739721
陟包ｽｳ陝ｲ�ｶ騾ｵ�ｽ,陝ｷ�ｳ隰鯉ｿｽ,27,2015,,755733,359790,395943
鬯･蜷晢ｽｷ譎画＝,陝ｷ�ｳ隰鯉ｿｽ,27,2015,,976263,472308,503955
隲｢蟶幢ｽｪ蟶ｷ諱�,陝ｷ�ｳ隰鯉ｿｽ,27,2015,,1385262,654380,730882
鬯ｮ蛟｡陦埼ｵ�ｽ,陝ｷ�ｳ隰鯉ｿｽ,27,2015,,728276,342672,385604
驕紋ｸ橸ｽｲ�｡騾ｵ�ｽ,陝ｷ�ｳ隰鯉ｿｽ,27,2015,,5101556,2410418,2691138
闖ｴ蜊��ｳﾂ騾ｵ�ｽ,陝ｷ�ｳ隰鯉ｿｽ,27,2015,,832832,393073,439759
鬮滂ｽｷ陝�螳域＝,陝ｷ�ｳ隰鯉ｿｽ,27,2015,,1377187,645763,731424
霎ｭ鬆第た騾ｵ�ｽ,陝ｷ�ｳ隰鯉ｿｽ,27,2015,,1786170,841046,945124
陞滂ｽｧ陋ｻ�ｽ諱�,陝ｷ�ｳ隰鯉ｿｽ,27,2015,,1166338,551932,614406
陞ｳ�ｮ陝�螳域＝,陝ｷ�ｳ隰鯉ｿｽ,27,2015,,1104069,519242,584827
魄厄ｽｿ陷井ｻ呻ｽｳ�ｶ騾ｵ�ｽ,陝ｷ�ｳ隰鯉ｿｽ,27,2015,,1648177,773061,875116
雎蝉ｹ滂ｽｸ�ｽ諱�,陝ｷ�ｳ隰鯉ｿｽ,27,2015,,1433566,704619,728947
